0203050504040206040106050000000500040202
0402040406060300030603060503060203010005
0604050500010300044403000503060405060600
0502060504010306020405030144020305010504
0100030000010000040602020002040100008081
0304010145000201050206060203010105809491
0000060402010601000645040003038081949191
2122030605024406000104010303809491919191
3533220000060500000004038081949191919191
2535320001030202020380819491919191919191
3535332201050602808194919191919191919191
2525253200028081949191919191919191919191

image image:tundra
position 4 -3 1 *
sprite @7,3 sprite:jigpiece (u32)0
song song:first_frost
rsprite (u16)0 sprite:goat (u8)200 (u24)0
rsprite (u16)0 sprite:leopard (u8)20 (u24)0
