0401060102030600060405040202010406060006
0601010603000405060201010303050402050305
0005000603020604010201050506060606000303
0002050403050304000401020005030503040301
0301050104020405000404040000060302000404
0506010506060304020605020005060106010502
0503000506030506040503040306030100010301
0002000401060404000306010101010201050202
0404010104030600000401020205000600040201
0404000300030403050100050600010001060100
0100050105010100020504050005060000020106
0504050203010101020600030105030302040600

image image:tundra
position 3 -5 1 *
rsprite (u16)0 sprite:goat (u8)200 (u24)0
rsprite (u16)0 sprite:leopard (u8)20 (u24)0
