0601010406040602020600060200020002030406
0505030600060001040306030200060001030404
0402000206000403040604010206000206040104
0100000304050306020505030604030406060603
8181818201000101040604050500000200050300
9191919382020002030204010104060305020104
9191919193818204050302040605000106020206
9191919191919382060202060506060003020303
9191919191919193818181818182040503040002
9191919191919191919191919193818181818181
9191919191919191919191919191919191919191
9191919191919191919191919191919191919191

image image:tundra
position -5 -3 1 *
song song:first_frost
sprite @10,5 sprite:jigpiece (u32)0
rsprite (u16)0 sprite:goat (u8)200 (u24)0
rsprite (u16)0 sprite:leopard (u8)20 (u24)0
