0206040305020506050500060305050200010204
0203040502030106040305000505000300030305
0203010003000300020404030503040500000600
0406040300060300020006060300010605030600
0103020306050204050306030303040443060006
0103040203040605010506060400050303050201
0401050106000203040306060101050600010200
0000010202020000010403030602020104000500
0005030005040001040443040104010301030502
0306054501000503030605010300060306020603
0104010206010601030302060604040020212206
0000050004050200010400020306202134313321

image image:tundra
position -4 -4 1 *
sprite @7,4 sprite:jigpiece (u32)0
song song:first_frost
rsprite (u16)0 sprite:goat (u8)200 (u24)0
rsprite (u16)0 sprite:leopard (u8)20 (u24)0
