0501000201010002040306000305030300040003
0302020002040000000203030303030300060105
0201060005030406040405030005010206040605
0303000406000404020201020004020004010406
0504020204050102060100060006050003010200
0100010005030202050406030302030100050403
0001060005040006010205030400040206000301
0000030600060006010406010402060306000505
0405060302050406000004000300050200060205
0501030504060303050406020505050603030502
0300050402050304050304030300030100000301
0304000500020203020302020202020402020000

image image:tundra
position 4 -4 1 *
sprite @16,1 sprite:jigpiece (u32)0
song song:first_frost
rsprite (u16)0 sprite:goat (u8)200 (u24)0
rsprite (u16)0 sprite:leopard (u8)20 (u24)0
