2121212121212121212121212121212121212121
2113313131313131313131313131313131311421
2122070401070505030305070701070101072021
2122000005000204070706010300040606042021
2122070110111111120203041011111203032021
2122030720212121231111112421212207052021
2122000120212113313131313114212202012021
2122070230313132040106000330313206052021
2122010601020005030406010605000602072021
2122000706030404060104000705030502042021
2123111111111111111112061011111111112421
2121212121212121212123112421212121212121

image image:botire_int
door @11,10 map:63 @1,7 0x0000
parent map:63
