2121212121212121212121212121212121212121
2121212121212121212121212121212121212121
2121212121133131313131313114212121212121
2121212121220607000106000220212121212121
2121212121220000000303090420212121212121
2121212121220506070606000620212121212121
2121212121220503050703060320212121212121
2121212121220505050603060120212121212121
2121212121231112081011111124212121212121
2121212121212123112421212121212121212121
2121212121212121212121212121212121212121
2121212121212121212121212121212121212121

image image:botire_int
door @8,8 map:11 @11,5 0x0000
parent map:11
door @11,4 map:146 @7,4 0x0000
