2121212121212121212121212121212121212121
2121212121212121212121212121212121212121
2121212121212121212121212121212121212121
2121211331313131313131311421212121212121
2121212200000000000000002021212121212121
2121212200000200000000002021212121212121
2121212200000000000000002021212121212121
2121212200000000000000002021212121212121
2121212311111111110111112421212121212121
2121212121212121212121212121212121212121
2121212121212121212121212121212121212121
2121212121212121212121212121212121212121

image image:cheapside_int
door @9,8 map:14 @12,4 0x0000
parent map:14
door @6,5 map:145 @10,5 0x0000
sprite @11,4 sprite:treasure (u8:itemid)match (u8:quantity)10 (u16:fld)always
