2121212121212113320106202121212121212121
2121212121211332020200301421212121212121
1331313114212202010202003014212121212121
2202050720212202070705040030313131142121
2201050220212205050502040401040005303131
2207020020212312020303020507070602050703
2200050020212123120307020702020302060605
2202080520212121231202060306070600031011
2204030120212121212311120306050410112421
2311111124212121212121231111111124212121
2121212121212121212121212121212121212121
2121212121212121212121212121212121212121

image image:caves
position -2 0 2 *
parent map:14
sprite @2,4 sprite:treasure (u8:itemid)fishpole (u8:quantity)0 (u16:fld)0
dark
