9183a1a1a1a205020601a0a18491919191919191
a1a202060002050506020000a0a1a1a184919191
05010300040602000604060406020105a0a1a1a1
0305000205000405040500020202060006000606
0206000305010202030303030403030100040302
0503030004040404030006000303040202050103
0506060501020200000004050504020002060203
0300030400060200000205050303000304000202
0602000504030305060206000001020305000506
0201010206050503060602020500010500010202
0006030505040602010404000502000600060600
0001030206010500000203030100000404060500

image image:desert
position 4 3 1 *
song song:blood_for_silver
sprite @8,6 sprite:jigpiece (u32)0
rsprite (u16)0 sprite:koala (u8)100 (u24)0
