9191919191919191919191919191919191919191
919191919183a1a1849191919191919191919191
9191919191920003909191919191919191919191
9191919191924406a0a1a1a1a1a1a1a1a1a1a1a1
9191919191920006060601010205020105010106
9191919183a20602050502000102040404000601
a1a1a1a1a2020100060101020301040301050203
0405060104050005060004060502040402050004
0503020602040002050203010105000400020404
0404010001010100000603020002010001040505
0405000004040603000504050002000302000606
0200000201010306020106020303020205030001

image image:desert
position -2 4 1 *
sprite @9,6 sprite:jigpiece (u32)0
song song:blood_for_silver
rsprite (u16)0 sprite:koala (u8)100 (u24)0
