9191919191919191919191919191919191919191
9191919191919191919191919191919191919191
9191919191919191919191919191919191919191
9191919191919191919191919191919191919191
9191919191919191919191919191919191919191
9191919191919191919191919191919191919191
9191919191919191919183a1a1a1a1a1a1a1a1a1
a1a1a1a1a1a1a1a1a1a1a2050301050001050201
0601020002000106030000020203030404010501
0104000604030206050103020504000300000304
0105050405010103050104050003000604050005
0502040504030106050304020202000501000604

image image:desert
position -3 4 1 *
sprite @9,8 sprite:jigpiece (u32)0
song song:blood_for_silver
rsprite (u16)0 sprite:koala (u8)100 (u24)0
