0601030100050505050601040602000600000302
0400010402010600010302000306020003030406
0402060105030603040400020603000406060101
0103040301040601000301040000020202010105
0506000605010304050606010506000202000506
0205050505040505000200000000000601040402
0101060504050301020600060505060105030602
0105030205050006030402040200050403060604
0504030505050400060402030103060406020005
0301050506060603040306040002030103010603
0401040304030002060005050600000000040602
0403010403030600040106010201060105010504

image image:desert
position -5 5 1 *
rsprite (u16)0 sprite:koala (u8)100 (u24)0
