920403030003030603010005010006000006a084
92020605020500010405060404030502020505a0
9206060304050506000600050004030205010503
9200050204050402020206010000000205020405
9202050601030505000201060505060205020300
9201010200010603050101050500040202050103
9200040603020100060105050100040403030401
9201030304050506020404060201030606010305
9206060405000201000500000303000504050006
9205010601030400020406010504010601010501
9201000305050306040101060106000300020280
9201030104050106050601040401040103048094

image image:meadow
position -5 1 1 *
song song:toil_and_trouble
sprite @9,5 sprite:jigpiece (u32)0
rsprite (u16)0 sprite:leopard (u8)100 (u24)0
