9191919191919191919191919191919191919191
9191919191919191919191919191919191919191
9191919183a1a1a1849191919191919191919191
91919183a2000401a08491919191919191919191
9191919203010300069091919191919191919191
919191920306050400a0a1849191919191919191
9191919200030105020200909191919191919191
9191919382030106000205909191919191919191
9191919193818182020102909191919191919191
9191919191919193818181949191919191919191
9191919191919191919191919191919191919191
9191919191919191919191919191919191919191

image image:meadow
position -3 1 1 *
sprite @6,5 sprite:jigpiece (u32)0
