1331313131313132000000000030313131313114
2200000000000000000000000000000000000020
2200000000000000000000000000000000000020
3200000000000000000000000000000000000030
0000000000000000000000000000000000000000
0000000000000000000000000000000000000000
0000000000000000000000000000000000000000
0000000000000000000000000000000000000000
0000000000000000000000000000000000000000
1200000000000000000000000000000000000010
2200000000000000000000000010120000000020
2311111111111112000000001024231111111124

image image:meadow
position 0 0 1 0
oob (u8:mapoob)farloop (u8:mapoob)repeat
sprite @9,5 sprite:hero (u32)0
