2121212200000000000000252626262626262626
2121212200000000000000351926262626262626
2113313200000000000000002526262626262626
3132000000000000000000003519262626262626
0000000000000000000000000025262626262626
0000000000000000000000000035192626262626
0000000000000000000000000000351926262626
0000000000000000000000000000003519262626
0000000000000000000000000000000035361926
0000000000000000000000000000000000003536
0000000000000000000000000000000000000000
0000000000000000000000000000000000000000

image image:meadow
position 1 1 1 *
