9191919191919191919191919191920106050501
919191919191919183a1a1a18491920300040600
91919191919191919203a4049091938200040106
9191919191919191920406009091919202020006
9191919191919191938182049091919205010400
9191919191919191919193819491919382010005
9191919191919191919191919191919192060503
9191919191919191919191919191919192060304
9191919191919191919191919191919193820106
9191919191919191919191919191919191938181
9191919191919191919191919191919191919191
9191919191919191919191919191919191919191

image image:meadow
position 4 4 1 *
debugmsg "4,4"
sprite @16,4 sprite:jigpiece (u32)0
