0000000000000000000000000000000000000000
0000000000000000000000000000000000000000
0000000044444400000000444400000000000000
0000000000004400000044004400000000000000
0000000000004400000000444400000000000000
0000000000004400000000004400000000000000
0000000000004400440000004400000000000000
0000000000000000440000000000000000000000
0000000000000000000000000000000000000000
0000000000000000000000000000000000000000
0000000000000000000000000000000000000000
4444444444444444444444444444444444444444

image image:meadow
position 7 9 1 *
