0505010502050404060500050602030604050006
0100060503060004010203060400010005000606
0103060204010201040206020303010102010503
0500010104020202010405010501030102060106
8181818181818200010305010106020404808181
9191919191919381818181818181818181949191
9191919191919191919191919191919191919191
9191919191919191919191919191919191919191
9191919191919191919191919191919191919191
9191919191919191919191919191919191919191
9191919191919191919191919191919191919191
9191919191919191919191919191919191919191

image image:tundra
position 5 -3 1 *
song song:first_frost
rsprite (u16)0 sprite:goat (u8)200 (u24)0
rsprite (u16)0 sprite:leopard (u8)20 (u24)0
