2121212113313131313131313131313131313131
2121211332070305050307000706010406020503
2121133207000506010507020603000407000007
2121220003040403010100030201060406030600
2121220004030602010301030205000506020300
2121231201000000050305060703060101031011
2121212312040506040407040605050005102421
2121212123111207040206060101061011242121
2121212121212311111112060602102421212121
2121212121212121212123111111242121212121
2121212121212121212121212121212121212121
2121212121212121212121212121212121212121

image image:caves
position 0 0 2 0
sprite @10,4 sprite:jigpiece (u32)0
sprite @6,4 sprite:treasure (u8:itemid)snowglobe (u8:quantity)0 (u16:fld)0
