0506010606050006040601030105050300060602
0005010606050300040101050204020304060204
0203050006030306030202000402020401020400
0604040305010300030100050000040601020405
0200030102000300040400020305000302000304
0506050204010205040100030306060004060100
0500050006010401050300030300040105000304
0304030403060205060600050205060405060305
0201030003030401030202040101030000050306
0405000301010606030205040004030600000103
0102030306060102010603060206010503050402
0304000503060100050101060300030201030403

image image:tundra
position 5 -4 1 *
