0003020301000601050004060005040401010405
0403030600020600060601050003000304020201
0506030101050205040002020306030402000603
0306000106020000040306030406060402010603
0004030506000405060501000005030002010505
0306030601040503010504020402020204060502
0300000401030502050100020300010604000000
0005010303060604000506000305020401040200
0403010201010003060606000001050103060006
0005060200010300040301020302000000030606
0204000403000104060000000304010200040506
0404000602060501030101040605000503010306

image image:tundra
position 5 -5 1 *
