3131313131313131142121212121212121212121
0704070303060100303114212121212121212121
0707070001020504000630311421212121212121
0307000007030603050400013031142121212121
0006030406063300020500050705303131313131
1207070006013405000104070504020304070406
2207010507073306040101040000030101101111
2312050306050300030006030402030401202121
2123120401000205020006040106050100202121
2121220305050105030605010000000202202121
2121220104000307000104010704060102202121
2121220002030004050503060306070200202121

image image:caves
position 1 0 2 *
sprite @9,6 sprite:jigpiece (u32)0
dark
song song:bone_soup
