3131313131313131142121212121212121212121
0704070303060100303114212121212121212121
0707070001020504000630311421212121212121
0307000007010000050400013031142121212121
0006030406050005020500050705301421212121
1207070006000702000104070504003014212121
2207010507030801040101040000030130142121
2312050306030003030006030402030001202121
2123120401000205020006040106050100202121
2121220305050105030605010000000202202121
2121220104000307000104010704060102202121
2121220002030004050503060306070200202121

image image:caves
position 1 0 2 *
sprite @9,6 sprite:jigpiece (u32)0
dark
song song:bone_soup
