2113320702000705060000010704010204202121
2122070403020106040607060404030003202121
3132040207030404010002060507010705202121
0703030102050307013303040405060610242121
0603030101040305070003060202011024212121
0401000502020701030603060400073031313131
0507053401040507330006070106020100000207
0406060000010505060707010710111111111111
0201010107010304000600061024212121212121
0707040603060700060507102421212121212121
0204060102041012021011242121212121212121
1111111111112422042021212121212121212121

image image:caves
position 1 1 2 *
sprite @11,5 sprite:jigpiece (u32)0
sprite @14,2 sprite:firepot (u8:radius_m)3 (u24)0
