0102030205030402050601050503000102040103
0003000102060002020103020205040004060002
0000060000000104060301060300060300050000
0504060003060306050303000605050004000301
0502020505060501030503040600040603030401
0301000601050305010100030104010001000105
0606000303000204030606010303020206060300
0501060204030003050303010500000006050304
0206000100020203000602000404020106060005
0503010100060502040201020605040300040005
0305020203010505060105010501030603030004
0500010401060201020502040406000302020602

image image:tundra
position 4 -5 1 *
