2113320702000705060000010704010204202121
2122070403020106040607060404030003202121
3132040207030404010002060507010705202121
0703030102050307013303040405060610242121
0603030101040305070003060202011024212121
0401000502020701030603060403072021212121
0507053401040507330006070102102421212121
0406060000010505060707010710242121212121
0201010107010304000600061024212121212121
0707040603060700050007102421212121212121
0204060102041011111111242121212121212121
1111111111112421212121212121212121212121

image image:caves
position 1 1 2 *
sprite @11,5 sprite:jigpiece (u32)0
