2121212121212121211331313131313131313114
2121212121212121133204020407060402020030
2121212121212113320404060006000606070306
2121212121211332000201060740420403070404
2121212121212206050702024054534141414141
2121212121133204000700405451515151515151
2121212121220005000503505151515151515151
2121212121220501060103505151515151515151
2121212121220104010540545151515151515151
2121212121220500040250515151515151515151
2121212121231112000250515151515151515151
2121212121212122030150515151515151515151

image image:caves
position 1 1 2 *
sprite @6,7 sprite:jigpiece (u32)0
