2200070104000701073031313131313131142121
2202070301070400060205050106050507303114
2202020503030106020102070201070704060530
2204050702050206070207010500020401010700
2200050303020207030505000306040503010305
2207330106030205060201060606010107060007
2202340602060107010407060001050206050201
2200330601000601010400030705070502030202
2207030303010206060204000100000503070006
2201020605030100060104040101060102000106
2204050007040207060601070101030601010007
2311111111111204050301040302101111111111

image image:caves
position 0 1 2 *
sprite @9,5 sprite:jigpiece (u32)0
dark
