2121212121212121212121212121212121212121
2121212121212121212121212121212121212121
2121212121133131313131142121212121212121
2121212121220203020706301421212121212121
2121211331320607030502022021212121212121
2121133206070405060201033014212121212121
2121220003060107010407050120212121212121
2113320601000601010400030730142121212121
2122040102010206060204000007202121212121
1332070804030100060104040101202121212121
2206050501040207060601070102202121212121
2311111111111204050301040303202121212121

image image:caves
position 0 1 2 *
sprite @9,5 sprite:jigpiece (u32)0
door @3,9 map:42 @14,9 0x0000
