0504030506020103030506020504020100050303
0500030401010303050602060201030204010202
0503020101000401040103010202060501010403
0005000600060300030506000104000406000006
0300020605020105010004020002040602030505
0405040405050504010400060004060205060101
0503030301050200030000030200020604050003
0504050603020602020506040601020001040300
0405010203050503000005040303060101000102
0403060601000402030102000401000101020501
0003040301010401020606060403060501040202
0505050301050005030506040506060406040403

image image:meadow
position 2 -5 1 *
