2121212121212202020705010400202121212121
2121212121212312070403040503202121212121
2121212121211332070500000010242121212121
1331311421133202043333330120212121212121
2200062021220702050303010020212121212121
2312073014220700000106060520212121212121
2122030520220402050707030730142121212121
2123111124220702060503010203202121212121
2121212113320303010102050600202121212121
2121212122010304010704070604202121212121
2121212123111206010402030603202121212121
2121212121212204050200050501202121212121

image image:caves
position 0 2 2 *
sprite @6,6 sprite:jigpiece (u32)0
sprite @5,9 sprite:firepot (u8:radius_m)3 (u24)0
