2121212121212202020705010400202121212121
2121212121212312070403040503202121212121
2121212121211332070500000010242121212121
2121212113313202040603050120212121212121
2121212122050602050303010020212121212121
2121212122030100000106060520212121212121
2121212122020002050707030730142121212121
2121212122050102060503010203202121212121
2121212122050403010102050600202121212121
2121212122050504010704070604202121212121
2121212123111206010402030603202121212121
2121212121212204050200050501202121212121

image image:caves
position 0 2 2 *
sprite @6,6 sprite:jigpiece (u32)0
dark
sprite @5,9 sprite:firepot (u8:radius_m)3 (u24)0
