2121212121212205030300000203202121212121
2121212121212312070205010506202121212121
2121212121211332070605040210242121212121
2121212121133202070100070020212121212121
2121212121220107020604000620212121212121
2121212121220707030601070720212121212121
2121212121220503020302040230142121212121
2121212121220105030601050205202121212121
2121212113320304000402050505202121212121
2121212122020707050407000601202121212121
2121212123111205040001040307202121212121
2121212121212206030306000401202121212121

image image:caves
position 0 2 2 *
sprite @6,6 sprite:jigpiece (u32)0
sprite @5,9 sprite:firepot (u8:radius_m)3 (u24)0
rspriteres rsprite:uwest
