2121212121212204000000000705202121212121
2121212121212200000000000610242121212121
2121212121212201000000010520212121212121
2121212121212204000000041024212121212121
2121212121212204000001052021212121212121
2121212121212207050000102421212121212121
2121212121212312060005202121212121212121
2121212121212122070001202121212121212121
2121211331313132030000303131313114212121
2121212205070604020001000507070320212121
2121212206010406050201070605040420212121
2121212311111111111111111111111124212121

image image:caves
position 0 3 2 *
sprite @12,9 sprite:jigpiece (u32)0
