0003030405050400040000000304060306010300
0603040006010301000104010305040100050001
0604050202050400040402030500040303050304
0204010402060202020002030100060403010501
0302030305040206010404010301060106020400
0606060506050103020600060004040001020202
0006040302040302030106030505020200040101
0300040000060603030506000204030400000504
0406030404060406040004040001000502000506
0602030004020305040506000605050201000005
0401000101010201020100020105030405030001
0101000306010006020005030000000305050402

image image:tundra
position 0 -5 1 *
