2121212121212121212121212121212121212121
2121212121212121212121212121212121212121
2121212113313131313131313131142121212121
2121212122010000000002020400202121212121
2121212122040400020000040001202121212121
2121212122000303020400000304202121212121
2121212122000100000403030300202121212121
2121212122010404020201030400202121212121
2121212123111111341111111111242121212121
2121212121212121212121212121212121212121
2121212121212121212121212121212121212121
2121212121212121212121212121212121212121

image image:tundra_int
door @8,8 map:24 @5,3 0x0000
parent map:mn_ext
position 1 0 0 0
sprite @10,5 sprite:compasstech (u16:activity)magneticnorth (u16:activity_arg)0
