2121212121212121212121212121212121212121
2121212121212121212121212121212121212121
2121211331313131313131313131313114212121
2121212200000000000000000000000020212121
2121212200000000000000000000000020212121
2121212200000000000000000000000020212121
2121212200000000000000000000000020212121
2121212200000000000000000000000020212121
2121212200000000000000000000000020212121
2121212311111101111111111111111124212121
2121212121212121212121212121212121212121
2121212121212121212121212121212121212121

image image:cheapside_int
door @7,9 map:5 @2,3 0x0000
position 0 1 0 0
sprite @7,4 sprite:brewer (u16:activity)brewer (u16:activity_arg)0
debugmsg "TODO\u0020Single\u0020servings"
parent map:5
