9191919191919191919191919191919191919191
9191919191919191919191919191919191919191
9191919191919191919191919191919191919191
9191919191919191919191919191919191919191
9191919191919191000000919191919191919191
9191919191919191919100919191919191919191
9191919191919191910000919191919191919191
9191919191919191919100919191919191919191
9191919191919191000000919191919191919191
9191919191919191919191919191919191919191
9191919191919191919191919191919191919191
9191919191919191919191919191919191919191

image image:meadow
position 3 3 1 *
debugmsg "3,3"
