2113320000000000000000000025262626262626
2122000000000000000000001529262626262626
1332000000000000000000002526262626262626
3200000000000000000000152926262626262626
0000000000000000000015292626262626262626
0000000000000000000025262626262626262626
0000000000000000000025262626262626262626
0000000000000000000025262626262626262626
0000000000000000000035192626262626262626
1200000000000000000000252626262626262626
2312000000000000000000252626262626262626
2123111200000000000000252626262626262626

image image:meadow
position 1 0 1 *
