0105010006019091919191919191919191919191
0505040100809491919191919191919191919191
0105068081949191919191919191919191919191
0602809491919191919191919191919191919191
8181949191919191919183a1a1a1849191919191
91919191919191919183a2000103909191919191
919191919191919183a206050006909191919191
9191919191919191920301008081949191919191
9191919191919191938181819491919191919191
9191919191919191919191919191919191919191
9191919191919191919191919191919191919191
9191919191919191919191919191919191919191

image image:meadow
position 3 3 1 *
sprite @2,2 sprite:jigpiece (u32)0
buriedtreasure @12,6 (u16:fld)bt10 (u16:itemid)gold 10 0
rspriteres rsprite:isthmus
