2121212121212121212121212121212121212121
2121212121212121212121212121212121212121
2121212121212121212121212121212121212121
2121133131313131313131313131313131142121
2121220000000000000000000000000002202121
2121220000000000000000000000000000202121
2121220000000000000000000000000000202121
2121220000000000000000000000000000202121
2121231111111101111111111111111111242121
2121212121212121212121212121212121212121
2121212121212121212121212121212121212121
2121212121212121212121212121212121212121

image image:cheapside_int
door @7,8 map:5 @15,3 0x0000
position 2 1 0 0
parent map:5
sprite @3,7 sprite:jigpiece (u32)0
door @16,4 map:294 @10,5 0x0000
