2121212121212121212121212121212121212121
2121212121212121212121212121212121212121
2121212121212121212121212121212121212121
2121133131313131313131313131313131142121
2121220000000000000000000000030002202121
2121220000000000000000000000030000202121
2121220000000000000000000000030000202121
2121220000000000000000000000030000202121
2121231111111101111111111111111111242121
2121212121212121212121212121212121212121
2121212121212121212121212121212121212121
2121212121212121212121212121212121212121

image image:cheapside_int
door @7,8 map:5 @15,3 0x0000
position 2 1 0 0
parent map:5
sprite @13,5 sprite:jigpiece (u32)0
door @16,4 map:294 @10,5 0x0000
switchable @14,6 (u16:fld)undemo
