0305050202050103000001020000000600030201
0402010501020403000406020602030506040000
0103010205000205020302020405050103040606
0100030303000303060603000403030405010500
0002060402020002050402040203040604020602
0006000400030403060102030504010604050103
0403020502010401030205040001060506030500
0206000303050406010606020201010202000000
0104050000020103010002000502050405040605
0104010106020503040404020300060606040200
0104060004020500040400030603000400040002
0001020305040202010503000006030506020404

image image:tundra
position -3 -5 1 *
