0603060104000502050302000100020301030106
0306010601040304060300020501010604020405
0001000005050103040603030104060400040103
0103030605000202020005020601030300010003
0203060106010405000601050105040002010104
0500010103040604010001060503060300030001
0602040003020603050401010004010200010204
0400030206020500000404020302010201060205
0302050304030204060104050203030200020606
0002040503020201040504030104050300000403
0105050405030500060500050100050400050606
0005040604060004050305040504060306040503

image image:meadow
position -4 -5 1 *
