2121212121212121212121212121212121212121
2121212121212121212121212121212121212121
2121211331313131313131313131313114212121
2121212200000000000000000000000020212121
2121212200000000000000000000000020212121
2121212200000000000000000000000020212121
2121212200000000000000000000000020212121
2121212200000000000000000000000020212121
2121212200000000000000000000000020212121
2121212311111111111111110111111124212121
2121212121212121212121212121212121212121
2121212121212121212121212121212121212121

image image:cheapside_int
door @12,9 map:5 @7,8 0x0000
position 3 1 0 0
sprite @12,4 sprite:carpenter (u16:activity)carpenter (u16:activity_arg)0
