0002050505050101000401010600060504040305
0102050006010102000301030102050000020301
0403040005010306020403010401010003040605
0401020400040405020501010502060306020200
0506060502050205030202010501050305030500
0002040402060300030603040100060301030403
0604010003030401000300050204000605020501
0101020103010203010206050000010505050306
0404050606020405040206030102000001000000
0001020003040600000201020400030200060406
0503060105050104030602010305010006020402
0401060602010501030503060605060201020600

image image:meadow
position -5 -5 1 *
