0202040005050406020602010002040502040200
0400010205060203050503060406040505030503
0100040400020301040005020001030604020304
0501050203050400000101020002020605050001
0406000400000004000106020006040203050201
0000020502010004020406050000000401010000
0301010404030400050202040302050101060302
0300010505040302030506000603050503010401
0006000102030203030204000100060600020106
0600020503010406010101010400020406050300
0101040100060000030105060505000004010105
0204060000050304000406010305050100020503

image image:tundra
position -6 -5 1 *
