2121212121212121212121212121212121212121
2121212121212121212121212121212121212121
2121212113313131313131313131142121212121
2121212122030006060704010505202121212121
2121212122003302330534053307202121212121
2121212122010100060003020602202121212121
2121212122020002060202060005202121212121
2121212122010602070100030405202121212121
2121212122030507070501000405202121212121
2121212123111111120010111111242121212121
2121212121212121231124212121212121212121
2121212121212121212121212121212121212121

image image:botire_int
position 1 2 0 0
door @9,9 map:46 @4,8 0x0000
sprite @6,7 sprite:jigpiece (u32)0
