2121212121212121212121212121212121212121
2121212121212121212121212121212121212121
2121212113313131313131313131142121212121
2121212122030200030305000101202121212121
2121212122020907101112010302202121212121
2121212122020701303132040604202121212121
2121212122040004050702060203202121212121
2121212122070701070200000302202121212121
2121212122050104060006010604202121212121
2121212123111111120210111111242121212121
2121212121212121231124212121212121212121
2121212121212121212121212121212121212121

image image:botire_int
door @9,9 map:53 @14,4 0x0000
parent map:53
position 2 2 0 0
sprite @12,4 sprite:jigpiece (u32)0
door @6,4 map:275 @11,6 0x0000
