0401020604060200020400030502060600020205
0604000001030202050100020301020301060403
0000060005000306040503040400030103020106
0202000206020406030201000200040400040602
8181818181820105020002010502808181818181
9191919191938181818181818181949191919191
9191919191919191919191919191919191919191
9191919191919191919191919191919191919191
9191919191919191919191919191919191919191
9191919191919191919191919191919191919191
9191919191919191919191919191919191919191
9191919191919191919191919191919191919191

image image:tundra
position -6 -3 1 *
song song:first_frost
