2121212121212121212121212121212121212121
2121212121212121212121212121212121212121
2121211331313131313131313131311421212121
2121212207060202060103000606002021212121
2121212202011012070702050200012021212121
2121212200052022060105070301002021212121
2121212201012022010303000700022021212121
2121212206073032060401050306022021212121
2121212207020600020306000302002021212121
2121212311111111120510111111112421212121
2121212121212121231124212121212121212121
2121212121212121212121212121212121212121

image image:botire_int
door @9,9 map:54 @4,4 0x0000
parent map:54
position 3 2 0 0
sprite @5,5 sprite:jigpiece (u32)0
sprite @12,5 sprite:knitter (u16:activity)knitter (u16:activity_arg)0
