2121212121212121212121212121212121212121
2121212121212121212121212121212121212121
2121212121212121212121212121212121212121
2121212121133131313131313114212121212121
2121212121220101040401000320212121212121
2121212121220300000000000620212121212121
2121212121220200000000000620212121212121
2121212121220202070305000320212121212121
2121212121231111120610111124212121212121
2121212121212121231124212121212121212121
2121212121212121212121212121212121212121
2121212121212121212121212121212121212121

image image:battlefield_int
door @9,8 map:57 @4,6 0x0000
parent map:57
position 0 3 0 0
sprite @7,6 sprite:jigpiece (u32)0
