0003020604010406060205030502404124252525
0200060302020601030302020306030440414141
0404040500020603040103000501040403020506
0202020603040303020406050101020600010606
0005050404020304000301010304010605030220
0606020502010000060680818201050605060230
0200020405010280818194919381820402052034
0306040602808194919191919191938181824041
0404008081949191919191919191919191938181
8181819491919191919191919191919191919191
9191919191919191919191919191919191919191
9191919191919191919191919191919191919191

image image:tundra
position -4 -3 1 *
song song:first_frost
sprite @8,4 sprite:jigpiece (u32)0
