2121212121212121212121212121212121212121
2121212121212121212121212121212121212121
2121212121133131313131313114212121212121
2121212121220401020607050720212121212121
2121212121220400000000000320212121212121
2121212121220101060000000620212121212121
2121212121220408040000000520212121212121
2121212121220701070402060220212121212121
2121212121231111120710111124212121212121
2121212121212121231124212121212121212121
2121212121212121212121212121212121212121
2121212121212121212121212121212121212121

image image:battlefield_int
door @9,8 map:22 @6,7 0x0000
parent map:22
position 1 3 0 0
sprite @7,4 sprite:treasure (u8:itemid)hookshot (u8:quantity)0 (u16:fld)0
sprite @11,4 sprite:jigpiece (u32)0
stompbox @7,6 (u16:fld)war_over
