2121212121212121212121212121212121212121
2121212121212121212121212121212121212121
2121212121133131313131313114212121212121
2121212121220401020607050720212121212121
2121212121220400000000000320212121212121
2121212121220200070000000620212121212121
2121212121220506040000000520212121212121
2121212121220203060402060220212121212121
2121212121231111120710111124212121212121
2121212121212121231124212121212121212121
2121212121212121212121212121212121212121
2121212121212121212121212121212121212121

image image:battlefield_int
door @9,8 map:22 @6,7 0x0000
parent map:22
position 1 3 0 0
sprite @11,4 sprite:jigpiece (u32)0
sprite @10,5 sprite:capnred (u16:activity)capnred (u16:activity_arg)0
