9191919191919191919191919191919191919191
9191919191919191919191919191919191919191
9183a1a1a1a1a1a1a18491919191919191919191
919203040103050306a084919191919191919191
91920645060004060100909191919191919183a1
91920604040005050501a0849191919191919203
919381818181820100050190919191919183a200
83a1a1a184919381818181949191919183a20103
9201020490919191919191919191919192010403
92004400909191919191919191919183a2060103
9201050090919191919191919191919201060106
9381818194919191919191919191919203060500

image image:meadow
position 2 2 1 *
sprite @10,6 sprite:jigpiece (u32)0
rspriteres rsprite:isthmus
