9191919191919191919191919191919191919191
9191919191919191919191919191919191919191
9191919191919191919191919191919191919191
9191919191919183a1a184919191919191919191
91919191919191920604909191919191919183a1
91919191919191938200a0849191919191919203
919191919191919192040190919191919183a200
9191919191919191938181949191919183a20103
9191919191919191919191919191919192010403
91919191919191919191919191919183a2060103
9191919191919191919191919191919201060106
9191919191919191919191919191919203060500

image image:meadow
position 2 2 1 *
sprite @17,8 sprite:jigpiece (u32)0
