2121212121212121212121212121212121212121
2121211331313131313131313131313114212121
2121212203010001000606000401070020212121
2121212206000706000105040701060720212121
2121212206000303070100020407060520212121
2121212205030a07040102040504010420212121
2121212201010602020002020206020520212121
2121212201070702070104040604060320212121
2121212205000601000505020103000020212121
2121212207010000020000050303030120212121
2121212311111111111111081111111124212121
2121212121212121212121212121212121212121

image image:fractia_int
door @11,10 map:26 @11,6 0x0000
parent map:26
position 0 4 0 0
stompbox @6,5 (u16:fld)mayor
