5151515151515151515151515151515151515151
5151515151515151515151515151515151515151
5151515151515151515151515151515151515151
5151515151436161616161616161445151515151
5151515151520200070106000003505151515151
5151515151520505060407030403505151515151
5151515151520501020407060004505151515151
5151515151520705010104050503505151515151
5151515151534141410941414141545151515151
5151515151515151515151515151515151515151
5151515151515151515151515151515151515151
5151515151515151515151515151515151515151

image image:fractia_int
parent map:26
position 1 4 0 0
sprite @13,7 sprite:jigpiece (u32)0
sprite @7,5 sprite:thingwalla (u16:activity)thingwalla (u16:activity_arg)0
door @9,8 map:26 @12,6 0x0000
