2121212121212121212121212121212121212121
2121212121212121212121212121212121212121
2121212121212121212121212121212121212121
2121212121133131313131313131142121212121
2121212121220603000405040706202121212121
2121212121220705060407030406202121212121
2121212121220701020407060007202121212121
2121212121220107030505050207202121212121
2121212121231111120010111111242121212121
2121212121212121231124212121212121212121
2121212121212121212121212121212121212121
2121212121212121212121212121212121212121

image image:botire_int
door @9,8 map:25 @13,6 0x0000
parent map:25
position 1 4 0 0
sprite @13,7 sprite:jigpiece (u32)0
sprite @7,5 sprite:thingwalla (u16:activity)thingwalla (u16:activity_arg)0
