3135253135353523414141414141243135329091
3131353523414142010102000400402423429091
3525352342020202040302010306064042069091
2525234205020204060603050100060402039091
3123420001010602030506050602050205019091
3532030000000304060004040101030204031515
3132010201060206050203030203010100029091
2342010406010503030404020401020500049091
3203030606050003040504050300040402809491
4205010303020403000201050601060100909191
0000030402030206060004000003020601909191
0002040606010001040002000205060304909191

image image:meadow
position -1 -3 1 *
sprite @10,4 sprite:jigpiece (u32)0
song song:barrel_of_salt
