2122000430311421212121211331313131311421
3132070602013031142113313200050002013031
0003060107050305202122010100040100050307
0403060206020302202122050701020001030707
0400010101020002302a32050605000507000502
1111111111120604010504020010111111111111
2121212121231205060203021024212121212121
2121212121212312020301102421212121212121
2121212121212122060405202121212121212121
2121212121212123151617242121212121212121
2121212121212121252627212121212121212121
2121212121212121212121212121212121212121

image image:caves
door @9,9 map:72 @14,1 0x0000
position 3 6 3 0
song song:bone_soup
sprite @6,2 sprite:jigpiece (u32)0
bump @9,4 (u16)0 strings:dialogue (u16)44
triggeronce @9,8 (u16:fld)escaped (u16:activity)escape (u16)0
sprite @11,2 sprite:firepot (u8:radius_m)3 (u24)0
dark
