0604060404000001030100010305020501050303
0002060501060601020302000002050203050402
0601050200000306020503050404000303050104
0501000005010202060204000203010606060002
0103000406040103020304040103040603030103
0202010503030301030005030402020203060200
0300060006030501030500010302050405060203
0204040304010205050603060103020004010205
0605030401030101020306030002010105040106
0602050305000102030300040400020003050206
0001010105040102000601020001030105010006
0202030402010204050105030502020002030101

image image:tundra
position -5 -4 1 *
song song:first_frost
sprite @10,5 sprite:jigpiece (u32)0
rsprite (u16)0 sprite:goat (u8)200 (u24)0
rsprite (u16)0 sprite:leopard (u8)20 (u24)0
