2121212121212121212121212121212121212121
3131313131142121212121212121211331313131
0301030203303131142121212113313207050102
0501000304020504303131283132030405010504
1203070705050405070101070401030207030305
2311120203040501060001000200040404041011
2121231111111205060204050206061011112421
2121212121212311111111111111112421212121
2121212121212121212121212121212121212121
2121212121212121212121212121212121212121
2121212121212121212121212121212121212121
2121212121212121212121212121212121212121

image image:caves
position 2 6 3 *
sprite @9,4 sprite:jigpiece (u32)0
