2121212121212121220401202121212121212121
2121133114211331320505303131313131313131
2121220220212202070503040405030000070000
3131320720212206010703020603050705010200
0402060120212311120300101111111111111111
1111120320211331320107202121212121212121
1331320330313206010706202121212121212121
2207050704050305040205202121212121212121
2311111111111111111111242121212121212121
2121212121212121212121212121212121212121
2121212121212121212121212121212121212121
2121212121212121212121212121212121212121

image image:caves
position 1 6 3 *
sprite @7,2 sprite:jigpiece (u32)0
dark
rspriteres rsprite:goblins
