0406030400020205010504000606060203000501
0002030301010305000300000003000104060004
0200000104020603010406014301000005050100
0600060100030604030206000604030106000601
0202020504040600050606030603040406030002
0100014402030505010205060504050504050504
0604030502030300000103030600020504030004
0004030301020105000304020301030005440600
0602040201060600060304050205030401060303
0604000304030520212121220206010605000603
0401060220212134353531332121220403010406
2121212134253125313135252531332121212121

image image:tundra
position -3 -4 1 *
song song:first_frost
sprite @9,6 sprite:jigpiece (u32)0
rsprite (u16)0 sprite:goat (u8)200 (u24)0
rsprite (u16)0 sprite:leopard (u8)20 (u24)0
