2121212121212121212121212121212121212121
3131313131313114212121211331313131313131
0505010607040130313129313200050603030302
0002060710120703010403050006060705060507
0702000130320506070400000507010506010002
1202060605060605030005000007020606010110
2312010001020707060005050501040010111124
2123111206030403010007030107050020212121
2121212311120706070107000403001024212121
2121212121231111111111111111112421212121
2121212121212121212121212121212121212121
2121212121212121212121212121212121212121

image image:caves
position 4 6 3 *
sprite @9,4 sprite:jigpiece (u32)0
