2113320000010401003031311421212121212121
3132030307020702030205063031142121212121
0605050206020407010407010603301421212121
0605040206031011120200030007052021212121
0105020506052013320003050203022021212121
1200000100073032000300060101012021212121
2205000207010505010005000302052021212121
2312030200000600030407060205072021212121
2123120506010707020207000200102421212121
2121231111120400030004101111242121212121
2121212121231111111111242121212121212121
2121212121212121212121212121212121212121

image image:caves
position 5 6 3 *
sprite @12,7 sprite:jigpiece (u32)0
