0000010601010504000001030006000303040000
0303050305020003040401000104000204020600
0302060606050401060406020206040102020405
0404030605020603050303040300030004030500
0005030380818181818206010303060405060400
0302008094919191919381820603050304030405
8181819491919191919191920402034400020100
9191919191919191919191938200010303050320
9191919191919191919191919382010103062034
9191919191919191919191919193820406203431
9191919191919191919191919191938220342525
9191919191919191919191919191919230313525

image image:meadow
position 0 -4 1 *
sprite @15,8 sprite:jigpiece (u32)0
song song:first_frost
