2121212121212121212206030102020103030300
2121212121212121212202050403060301020405
2121212121212121212312050603060002010001
2121212121212121212122010602060402060002
2121212121212121212122040207020306010201
2121212121212121212123120707020000000503
2121212121212121212121220105060201060607
2121212121212121212121220006070004050207
2121212121212121212121220701020506040005
2121212121212121212121220702060307010103
2121212121212121212121220001070104021011
2121212121212121212121220304040607042021

image image:caves
position 0 5 3 *
sprite @14,5 sprite:jigpiece (u32)0
dark
