0404040105050605040301050506060502020502
0601000106020204000403000206010106050606
0003030002010100000106000506050401060301
0101040105030105060606060304050600030104
0602000105020006050600050005040003040002
0600010101054505040102050606020202060106
0501050404030500000301030103030203020204
2122050102040405030301034501040306010405
3533212202020400010205040402020505000506
2535353321212202010103020003000204050201
3135253531353321212121212121212203000201
3535253535313531253131253535353321212121

image image:meadow
position 1 -4 1 *
sprite @9,8 sprite:jigpiece (u32)0
song song:first_frost
