9191919191920600030203020002050105000105
9191919191938205000505000005010005060002
9191919191919382060006030102020205020203
9191919191919192040004000202010001010202
9191919191919192040502010603030201040406
9191919191919192030501010200020104040001
9191919191919192000403050300020005060001
9191919191919193818181818182020001020201
9191919191919191919191919193818203030100
9191919191919191919191919191919381818181
9191919191919191919191919191919191919191
9191919191919191919191919191919191919191

image image:tundra
position 1 1 1 *
debugmsg "1,1"
sprite @11,4 sprite:jigpiece (u32)0
