0206020402000602060405000105000305040100
0201040102000506050205010203040006030100
0302010201030500010400020503000500010100
0103010300030004030300010405000606050106
0103040101050600030400020204040300020305
2201030500010003030602000300020301010480
3202050600010200050101040203030203040690
3206060501030002020601060505020603020490
3200000406050103050601010602030003050490
3205000002010601040204030606040103000690
3205060506030005050504060003050006020090
3321212121212206010400808181818181818194

image image:meadow
position 1 -2 1 *
