0001070004060304030600040130142121212121
0302060406020101050103050502202121212121
0201040706070507010205050500202121212121
0503010600050606070006030703202121212121
0702020106050400020002000200202121212121
0606070704070204060306010510242121212121
0500000110111111111111111124212121212121
0700101124212121212121212121212121212121
1111242121212121212121212121212121212121
2121212121212121212121212121212121212121
2121212121212121212121212121212121212121
2121212121212121212121212121212121212121

image image:caves
position 2 5 3 *
sprite @11,5 sprite:jigpiece (u32)0
dark
