0502030005040504040103060506000003060603
0601010205020502060306060001010605050400
0105040301000405000400010104050403010401
0406030505000105040001020301060100050503
0506020601020204000204030580820503010405
02060504a40100040004030601a0a20601060104
0104020100060506050202060204020004000102
0305060301030506060006060500060501050080
0001050402000003050305040105010304008094
0604030420212204040500042021220602809491
0120212134313322040100203435332280949191
2134352525353132000020342535353290919191

image image:meadow
position 2 -4 1 *
sprite @6,1 sprite:jigpiece (u32)0
song song:first_frost
