2121212122000601012021212203060405052021
2121212122060601062021212202040306062021
2121212122030007022021212206010005102421
2121211332000103022021212204010304202121
2121212200010104102421212203020001301421
2121212201030003202121212204040303002021
2121133200070510242121212312030501013031
2121220303031024212121212123120002040105
2113320403102421212121212121231200010201
2122070404202121212121212121212311120305
2122020310242121212121212121212121231111
2122000620212121212121212121212121212121

image image:caves
position 3 5 3 *
sprite @6,4 sprite:jigpiece (u32)0
dark
sprite @17,5 sprite:firepot (u8:radius_m)3 (u24)0
rspriteres rsprite:goblins
