0003000304050000000403020404030003040600
0205000000000303030103050201060001030504
0002030503060402030404030101040100000405
0302050105000402000300030204040001030302
0606010000050301000400050602060501020306
0206030602020401010205060305040205060301
0501808182050204060002030200060004060502
8181949193820101000206000602060202030604
9191919183a202050000060201020402a4020301
91919183a2040100040105a40404000300060002
919183a204000001030505000505050104020303
9191920003020103050604030303060604010305

image image:tundra
position 3 -4 1 *
sprite @10,2 sprite:jigpiece (u32)0
song song:first_frost
