2122010605070405060203202121212121212121
2122030303060304040700202121212121212121
2122050404040303020206301421212121212121
2123120503040503040203072021212121212121
2121231201010302030703023014212121212121
2121133200030107010000050020212121212121
3131320101030407020707040520212121212121
0600060705030701020107071024212121212121
0200060303070703060100002021212121212121
0003060401030401050302102421212121212121
1111111111111111111111242121212121212121
2121212121212121212121212121212121212121

image image:caves
position 4 5 3 *
sprite @10,5 sprite:jigpiece (u32)0
