2121212121212121212121212121212121212121
3131313131142121212121212121212121212121
0406040306303114212121212121212121212121
0404060702070230142121212121212121212121
0606020404030004303114212121212121212121
0201030600050401040620212121212121212121
1112040500010704020230142121212121212121
2123120304030407070003202121212121212121
2121220505070005020203301421212121212121
2121220400060304050304042021212121212121
2121231203020700050404033014212121212121
2121212202070707060003030220212121212121

image image:caves
position 5 4 3 *
sprite @7,6 sprite:jigpiece (u32)0
