212121212121212121212121e021212121212121
313131313114212121212121e021212121212121
040604030630311421212121e021212121212121
040406070207023014212121e021212121212121
060602040403000430311421e021212121212121
020103060005040104062021e021212121212121
111204050001070402023014e021212121212121
2123120304030407070003e0e021212121212121
2121220505070005020203301421212121212121
2121220400060304050304042021212121212121
2121231203020700050404033014212121212121
2121212202070707060003030220212121212121

image image:caves
position 5 4 3 *
sprite @7,6 sprite:jigpiece (u32)0
