2121212121212121212121212121212121212121
2121212121212121212121212121212121212121
2113313131313131313131313131313131311421
2122060701030500040002060004050402012021
2122060103040704060404040307020504062021
2122010301070000040706070407000106062021
2122010506030302040600060207010005072021
2122020407020206070001070001050701002021
2122000105010402030502010204060304052021
2123111111111111120810111111111111112421
2121212121212121231124212121212121212121
2121212121212121212121212121212121212121

image image:botire_int
door @9,9 map:64 @12,7 0x0000
parent map:64
