2122050300202121212121220202050304301421
2122010202301421212121220404000003003014
2122050001023014212121231205070002070620
2122000506010120212121212204010005040020
2122070201000420212121212207010600041024
2123120402010030142121212202060306052021
2121231200030504202121212202020603012021
2121212205050700202121212312050402043014
2121212206020300301421212122000201020420
2121212312070506042021212122010700040720
2121212122000406042021211332070201061024
2121212122040706072021212202010006022021

image image:caves
position 3 4 3 *
sprite @15,4 sprite:jigpiece (u32)0
dark
sprite @13,6 sprite:firepot (u8:radius_m)3 (u24)0
rspriteres rsprite:goblins
