0503070707040007050600040105202121212121
0700070605040701030705040505202121212121
0703000102010604030003070400202121212121
0300030202050103050506050510242121212121
1111111111111112060700001024212121212121
3131313131313132000305052021212121212121
0100060206010105020002072021212121212121
0604000200030700050401052021212121212121
0010120403040406020104062021212121212121
0430320010120505010102073014212121212121
0607070130320707020103050120212121212121
0504070604000601050005060120212121212121

image image:caves
position 2 4 3 *
sprite @9,4 sprite:jigpiece (u32)0
dark
rspriteres rsprite:goblins
