0507303132020704053032030302040230313204
0101030701010702020606020104060207040303
0302000101034041414141414142030602040701
0601040402015043614443614452020102060504
1112020100025052065052055052050503070110
3132000204075053415453415452000304060530
0503050507016061616161616162050004030404
0602010200050704630064046402020203020303
0505010000010404030504050406010505030107
0505070601040600040607070202000706060704
0202030107040201031012050502010606060700
0403101112070204002022040004070310120501

image image:caves
position 1 4 3 *
sprite @8,4 sprite:jigpiece (u32)0
dark
sprite @2,9 sprite:firepot (u8:radius_m)3 (u24)0
sprite @2,2 sprite:firepot (u8:radius_m)3 (u24)0
sprite @17,2 sprite:firepot (u8:radius_m)3 (u24)0
sprite @17,9 sprite:firepot (u8:radius_m)3 (u24)0
