2121212121212121212121212121212121212121
2121212121212121212121212121212121212121
2121212121133131313131313114212121212121
2121212121220002030105060120212121212121
2121212121220202010101060520212121212121
2121212121220700340434060620212121212121
2121212121220504030101020320212121212121
2121212121220505030703060320212121212121
2121212121231111111112081024212121212121
2121212121212121212123112421212121212121
2121212121212121212121212121212121212121
2121212121212121212121212121212121212121

image image:botire_int
door @11,8 map:11 @11,5 0x0000
parent map:11
