2121212121212121212204040604050206030101
2121212121212121212207050207060000060704
2121212121212121212202070101040303030202
2121212121212121212312030104050406050400
2121212121212121212122000005101111111111
21212121212121212121220102003031310d3131
21212121212121212121220307010104061d0602
2121212121212121212123120201040200060701
2121212121212121211331320602020006000401
2121212121212121212200000504020007010500
2121212121212121212207040101000406050704
2121212121212121212205050705050405030202

image image:caves
position 0 4 3 *
sprite @12,5 sprite:jigpiece (u32)0
dark
bump @17,6 (u16:activity)cryptmsg (u16)6 (u16)0
rspriteres rsprite:goblins
