2341414142909191919191919191919191919191
3280818181949191919191919191919191919191
3290919191919191919191919191919191919191
4290919191919191919191919191919191919191
8194919191919191000000919191919191919191
9191919191919191009100919191919191919191
9191919191919191000000919191919191919191
9191919191919191919191919191919191919191
9191919191919191919191919191919191919191
9191919191919191919191919191919191919191
9191919191919191919191919191919191919191
9191919191919191919191919191919191919191

image image:meadow
position 0 0 1 *
debugmsg "Caution:\u0020end-o-world"
