2341414142a0a1a1a1a1a1a1a1a1a1a1a1a1a1a1
3201020206040306040304010506040200020300
3200060505000600050200010506060303050503
3202040302050203040006050400050002020601
3204050302060106040200020003060302040403
3201060100020000060006020502020305030402
3204040105020401040603020600000306000305
3201000606020005050000020002000303030202
3204020002040301000301060480818201000506
3200030503030604060200018094919382050501
3204030105050304050003809491919193818181
3204020005010003000302909191919191919191

image image:meadow
position 0 0 1 *
debugmsg "Caution:\u0020end-o-world"
sprite @8,5 sprite:jigpiece (u32)0
