2121212121212121212121212121212121212121
2121212121212121212121212121212121212121
2121212121212121212121212121212121212121
2121212121212121212121133131311421133131
2121212121212121212113320401003031320302
2121212121212121212122060407050607040702
2121212121212121211332060401020000030203
2121212121212121212206000300010004040604
2121212121212121212203030606020306070307
2121212121212121212204050204010305020500
2121212121212121212206060406070107000606
2121212121212121212206040700040005070002

image image:caves
position 0 3 3 *
sprite @14,6 sprite:jigpiece (u32)0
dark
