2121212121212121212121212121212121212121
2121212113313131313131313131142121212121
2121212122000000000000000000202121212121
2121212122000000000000000000202121212121
2121212122000000000000000000202121212121
2121212122000000000000000000202121212121
2121212123111101111111111111242121212121
2121212121212121212121212121212121212121
2121212121212121212121212121212121212121
2121212121212121212121212121212121212121
2121212121212121212121212121212121212121
2121212121212121212121212121212121212121

image image:cheapside_int
door @7,6 map:16 @3,9 0x0000
parent map:16
