2121212121212121212121212121212121212121
2121212121212121212121212121212121212121
2121212121212121212121212121212121212121
313131310d142121212121212121212121212121
030302021d303131311421212121212121212121
0407000403030304013014212121212121212121
0007070200040303010730142121212121212121
0606050604040100030603301421212121212121
1207070500010706020601013014212121212121
2204040400020200010406010020212121212121
3207020303060105040406020730142121212121
0306050005020005020706040503202121212121

image image:caves
position 2 3 3 *
sprite @8,5 sprite:jigpiece (u32)0
dark
bump @4,4 (u16:activity)cryptmsg (u16)4 (u16)0
rspriteres rsprite:goblins
