2206020005020501202121212121212121212121
2203010201031011242121212121212121212121
2202060606052021212121212121212121133131
2201030506102421212121212121211331320505
2200020401202121212121212121133203020205
2203030701202121212121212113320601050406
2204020403301421212121211332030401000405
2203060603012021212121133201040706000305
2203050103042021212121220500000006040302
2312050500052021212121220303010406020701
2122030307062021212121220702010100041011
2122070200102421212121220504070406102421

image image:caves
position 3 3 3 *
sprite @14,6 sprite:jigpiece (u32)0
dark
sprite @17,10 sprite:firepot (u8:radius_m)3 (u24)0
rspriteres rsprite:goblins
