2121212121133131313131142121212121212121
2121211331320405020007301421212121212121
3131313204060705070307033014212121212121
0402070503030605030001050120212121212121
0704101206000706070600000630142121212121
0202303202060107040404040402301421212121
0302030501101111120306050401073031313131
0601070307202121231112070100040700010407
0106060210242121212123120607050605060403
0400051024212121212121231205070501060407
1111112421212121212121212311120000051011
2121212121212121212121212121231111112421

image image:caves
position 4 3 3 *
sprite @9,5 sprite:jigpiece (u32)0
rsprite sprite:leopard 20 2 (u32)0
rsprite sprite:koala 20 2 (u32)0
rsprite sprite:goat 20 2 (u32)0
rsprite sprite:soldier 20 2 (u32)0
