2121212121133131313131142121212121212121
2121211331320405020007301421212121212121
3131313204060705070307033014212121212121
0604050503030605030001050120212121212121
0310111206000706070600000630142121212121
0130293202060107040404040402301421212121
0601020201101111120306050401073031313131
060107030720212123111207010004070006052b
010606021024212121212312060705060502032b
040005102421212121212123120507050102022b
1111112421212121212121212311120000051011
2121212121212121212121212121231111112421

image image:caves
position 4 3 3 *
sprite @9,5 sprite:jigpiece (u32)0
