2121212121212121212121212121212121212121
2121212121212121212121212121212121212121
2121211331313131313131313131313114212121
2121212200000000000000000000000020212121
2121212200000000000000000000000020212121
2121212200000000000000000000000020212121
2121212200000000000000000000000020212121
2121212200000000000000000000000020212121
2121212200000000000000000000000020212121
2121212311111111111111011111111124212121
2121212121212121212121212121212121212121
2121212121212121212121212121212121212121

image image:cheapside_int
door @11,9 map:15 @11,4 0x0000
parent map:15
sprite @6,4 sprite:jigpiece (u32)0
