2113313131313131313131142121212121212121
2122040105060400040401202121212121212121
2122060307010607060307202121212121212121
2122060702050106050603202121212121212121
2122030600040402060000202121212121212121
2123111111120610111111242121212121212121
311421212122181a212113313114212121212121
0530313131320330313132020030142121212121
0501060407040703050705050006202121212121
0506070506040002060307070610242121212121
1111111206060605020110111124212121212121
2121212311111111111124212121212121212121

image image:caves
position 5 3 3 *
sprite @12,8 sprite:jigpiece (u32)0
sprite @4,2 sprite:princess (u32)0
switchable @6,6 (u16:fld)jailopen
song song:bone_soup
