2121212121212121212121212121212121212121
2121212121212121212121212121212121212121
2121212121133131313131313131311421212121
2113313131320606000607060306002021212121
2122050503020000000500040000042021212121
2122071011120500000408010000062021212121
3132042021220000000003010000012021212121
0204022021220605050403020004032021212121
1111112421231111111111111111112421212121
2121212121212121212121212121212121212121
2121212121212121212121212121212121212121
2121212121212121212121212121212121212121

image image:caves
door @10,5 map:139 @6,5 0x0000
parent map:14
position 0 0 2 *
