2121212121212121212121212121212121212121
2121212113313131313114212121212121212121
2121212122050300010220212121212121212121
2121212122040102070120212121212121212121
2121212122050208060220212121133131313131
2121212122070004050120212121220604010201
2121212122040507040420212121220410111111
2121212123111111120030313131320420212121
2121212121212121220302070202020220212121
2121212121212121231111111111111124212121
2121212121212121212121212121212121212121
2121212121212121212121212121212121212121

image image:caves
door @7,4 map:138 @11,4 0x0000
parent map:14
position -3 -1 2 *
dark
sprite @9,2 sprite:firepot (u32)0
sprite @5,2 sprite:firepot (u32)0
