2121212121212121212113311421212121212121
2121212121212121212122042021212121212121
2121212121212121212122073031313131313114
2121212121212121212122030600000605050020
2121212121212121212122061011111112051024
3131313131313131313132073031311422053031
0303020503060407010102030401022022010601
1111111111111111111111111111112422021011
2121212121212121212121212121212122072021
2121212121212121212121212121212123112421
2121212121212121212121212121212121212121
2121212121212121212121212121212121212121

image image:caves
position 4 2 3 *
sprite @14,6 sprite:jigpiece (u32)0
dark
rsprite sprite:loblin (u8:weight)10 (u8:limit)1 (u32)0
rsprite sprite:roblin (u8:weight)10 (u8:limit)1 (u32)0
rsprite sprite:snoblin (u8:weight)10 (u8:limit)1 (u32)0
rsprite sprite:boblin (u8:weight)10 (u8:limit)1 (u32)0
