2121212121212121212121212121212121212121
2121212121133131142121212121212121212121
2121133131320202301421212121212121212121
2113320602050401012021212121212121212121
3132000200000707013014212121212121212121
0306070406000405000330142121212121212121
0007070310111207050101202121212113313131
1111111124212312030403301421211332070404
2121212121212122000603003014133202030310
2121212121212123120202010330320101060720
2121212121212121231112020405010103021024
2121212121212121212123111111111111112421

image image:caves
position -1 0 2 *
parent map:14
