0601040404050401010000020102010205030606
0245010506060305000104020501050200040401
0306000502040406020006010304020203020604
0044010304045052010302040006060400000301
0200020306036062000002000303030203020606
0445030405016063515151515151515151515151
0000020604027071717171717171717171717171
0045020601030506050101000400050200050105
0606030403020100050006040303000101050004
0445060404000006040403050002040004050400
0602000603010600000305000206040003060203
8181818181818181818181818181818181818181

image image:meadow
position 1 2 1 *
song song:snowglobe
sprite @10,7 sprite:jigpiece (u32)0
