0506060002030404010006010001000504050403
0600060206060003060001000302010600020305
0200050502060504020602020401000401060206
0604030005050003010601050101000401060106
020202030502a405030401050104010604000300
0200010005020404060500030506020502020504
03030601050005040006000606a4040302040006
0305030104040506050001020504020103010203
0001000403030305060300060604000503010000
0305020004000305030503010205040101020301
0303000504060103050301020202060405000006
0404050204050200040004050606060104000301

image image:meadow
position 0 -3 1 *
