a1a1a1a240242341414141414141414141414141
0005050303303200000006010302020604050500
0301010145303203040602000001040201060004
0003030001404206000202050605050600050405
0204010406000601000000040400030602050005
0301020504050005050405060603000601000000
0503000401030202000002030401000300000500
0604010005030500020404030101040604040004
0002060205060005030204040202050404060303
0604050600000500040105020000000303010201
8181820303010300050305000000030002000302
9191938181820500050300040600000100050202

image image:meadow
position 1 0 1 *
sprite @8,2 sprite:jigpiece (u32)0
