2531353135353535353131312531253525253135
3135252525252535352525353131312535313525
2535253525253125353525312525353135253535
2531352535253125252341414141414141412431
3131312535352341414206030605050604064041
4141414141414205040204060603000601050401
0302050406020003000002030401000300000500
0604010005030500020404030101040604040004
0002060205060005030204040202050404060303
0604050600000500040105020000000303010201
8181820303010300050305000000030002000302
9191938181820500050300040600000100050202

image image:tundra
position 1 0 1 *
sprite @13,6 sprite:jigpiece (u32)0
