2121212121212121220303301421212201032021
2121212121212121231206063031313202053031
2121212121212121212204070502040700040503
2121212121212121212312060004060604000305
2121212121212121212122050401060604101111
2121212121212121212123120606020410242121
2121212121212121212121231203000630313131
2121212121212121212121212312070502070705
2121212121212121212121212123120304061011
2121212121212121212121212121231111112421
2121212121212121212121212121212121212121
2121212121212121212121212121212121212121

image image:caves
position 0 2 3 *
sprite @14,3 sprite:jigpiece (u32)0
dark
rspriteres rsprite:goblins
