2121212121212121212203000107010002042021
2121212121212121212204020601010403033031
2121212121212121212207070110111205020401
2121212121212121212205020320212312070202
2121212121212121212312000130142122050706
2121212121212121212122040003202122070405
2121212121212121212122020106301423120602
2121212121212121212122070607063014231200
2121212121212121211332020004000030142311
2121212121212121212200030302060504202121
2121212121212121133201061011120002301421
2121212121212121220203102421231204052021

image image:caves
position 0 1 3 *
sprite @10,3 sprite:jigpiece (u32)0
dark
