2121212121212200070305040420212121212121
3114212121212206020505001024212121212121
0030142121212311120410112421212121212121
0300303131142121220220212121212121212121
0506020405303131320630313114212121212121
0203040205000302030105040430142121212121
0703020403000006353637030507202121212121
0301020502020501454647070701202121212121
1201030102060604555657070302202121212121
2311120704040404020307040000202121212121
2121231111120302050206070410242121212121
2121212121231111111111111124212121212121

image image:caves
position 1 1 3 *
sprite @4,9 sprite:jigpiece (u32)0
dark
