2122000220212121212121220302202121212121
1332020120212121212121220102202121212121
2203020620212121212121220006303131142121
2203101124212121212121220000050502202121
2206202121212121211331320604060005303131
2202202121212121133207060003030605020606
2202303131313131320101000502060601101111
2200050007000204000203060207060200202121
2205010602050203030603000406010107303131
2204001011111202020305070700060505010501
2311112421212312050600040603060401101111
2121212121212122020204070510111111242121

image image:caves
position 2 1 3 *
sprite @13,3 sprite:jigpiece (u32)0
dark
