2121212202202113313114212113313207072021
2113313201201332060330142122010707032021
2122050204202200020504202122051011112421
2122071011242206101205202122033031313131
3132052013313201202205202122040606070207
0400072022040605202201202122031011111111
1111112422051011242311242122073014133114
2121133132053031313131311422060720220420
3131320006010506050507022023111124220220
0206000234011011111112043031313131320620
1111120405052021212122050705070202010520
2121231111112421212123111111111111111124

image image:caves
position 3 1 3 *
sprite @10,5 sprite:jigpiece (u32)0
dark
rspriteres rsprite:goblins
