2121212121212121220007062021212121212121
1331313131142121231204102421212121212121
2204020303301413313202303131142121212121
3206101201012022060700050502301421212121
01032022070430320738393a0504053014212121
11112422040604040348494a0400000120212121
21212122050705020258595a0604040120212121
2121212312070002030503010104041024212121
2121212123120402060204050110112421212121
2121212121231111111111111124212121212121
2121212121212121212121212121212121212121
2121212121212121212121212121212121212121

image image:caves
position 4 1 3 *
sprite @14,5 sprite:jigpiece (u32)0
dark
