2121212121212121212121212121212121212121
2121212121212121212121212121212121212121
2121212121212121212121212121212121212121
2121212121212121212121212121212121212121
2121212121212121212121212121212121212121
2121212121212121212121212121212121212121
2121133131313131142121212121212121212121
2113320702020701301421212121212121212121
2122010205050503042021212121212121212121
2122070202070306072021212121212121212121
2122070505020100102421212121212121212121
2123111112031011242121212121212121212121

image image:caves
position 5 0 3 *
sprite @2,10 sprite:jigpiece (u32)0
dark
sprite @5,7 sprite:treasure (u8:itemid)shovel (u8:quantity)0 (u16:fld)0
