4141412435234141414141414141414141414141
0301003035320101020303020001030001010006
0005004041420503000000050006000002060106
0401010545010100020005010005010500050604
0102000004030106030301060104040604040501
0002040201010000000204030601000300040604
0102050604050304050006000000010603030001
0606020302050504000004050301030100050402
0603030106020201000600010606020004040102
0306030104010103060602060101060304050500
0400000303060402030200050003000001000500
0106030003020605020001010300020600050200

image image:meadow
position 2 0 1 *
sprite @10,5 sprite:jigpiece (u32)0
