9191919191919191919191919191919191919191
a1a1a1a1a1a1a1a1a1a1a1a1a1a1a1a184919191
0604020401052627272801000603030190919191
0400000302003637373805050006060490919191
0400060002034647294806010604040490919191
5151515151515151515151515204050290919191
7171717171717171717171546204030090919191
0100262727280003050104606206060690919191
0304363737380404000403606204000690919191
0201462947480202000001606204000490919191
0602040500040602060604606203010390919191
0602000606040102020300606201000690919191

image image:cheapside
position 2 1 1 *
door @3,9 map:141 @7,6 0x0000
door @8,4 map:142 @11,6 0x0000
song song:snowglobe
