2121212121212121212121212121212121212121
2121212121212121212121212121212121212121
2121212121212121212121212121212121212121
2121212121212121212121212121212121212121
2121212121212121212121212121212121212121
212121212121212113310d313114212121212121
212121212113313132011d030430142121212121
2121212121220406030205050200202121212121
2121212121220004010605060505202121212121
2121212121220100000704040307202121212121
2121212121220305050600000007202121212121
2121212121231203010307050510242121212121

image image:caves
position 1 0 3 *
sprite @7,8 sprite:jigpiece (u32)0
dark
bump @10,6 (u16:activity)cryptmsg (u16)1 (u16)0
