2121212121212121212121212121212121212121
2121212121212121212121212121212121212121
2121212121212121212121212121212121212121
2121212121212121212121212121212121212121
2121212121212121212121212121212121212121
2121212121212121212121212121212121212121
2121212121212121212121212113313114212121
2121212121212121212121133132060730142121
2121212121212121212113320100050201301421
2121212121212121211332040600010002022021
2121212121212121212203030102050102062021
2121212121212121212203000502030404032021

image image:caves
position 0 0 3 *
sprite @12,8 sprite:jigpiece (u32)0
dark
rspriteres rsprite:goblins
