2121212121212121212121212121212121212121
2121212121212121212121212121212121212121
2121212113313131313131313131142121212121
2121212122020300050707060501202121212121
2121212122040a06000000000000202121212121
2121212122000404000000000005202121212121
2121212122070000000503000203202121212121
2121212123111111110811111111242121212121
2121212121212121212121212121212121212121
2121212121212121212121212121212121212121
2121212121212121212121212121212121212121
2121212121212121212121212121212121212121

image image:fractia_int
door @9,7 map:58 @8,1 0x0000
position 6 4 0 0
parent map:58
stompbox @6,4 (u16:fld)endorse_public
