2121212121212121212121212121212121212121
2121133131313131313131313131313131142121
2121220001070504050101040300050302202121
2121220700030606070300070700060a00202121
2121220403040206070300010602020102202121
2121220300070302060306070302030700202121
2121220103030700020605040700010407202121
2121220404060104020703010302010606202121
2121220607040503040201030406000403202121
2121231111111111120610111111111111242121
2121212121212121231124212121212121212121
2121212121212121212121212121212121212121

image image:fractia_int
door @9,9 map:58 @14,6 0x0000
position 4 4 0 0
parent map:58
stompbox @15,3 (u16:fld)endorse_casino
sprite @4,3 sprite:jigpiece (u32)0
