2121212121212121212121212121212121212121
2121212121212121212121212121212121212121
2121211331313131313131313114212121212121
2121212207000501060203020220212121212121
2121212201060000020401020620212121212121
2121212201040401010200060520212121212121
2121212200010205010502070120212121212121
2121212205040705060607030220212121212121
2121212311111111081111111124212121212121
2121212121212121212121212121212121212121
2121212121212121212121212121212121212121
2121212121212121212121212121212121212121

image image:fractia_int
door @8,8 map:25 @6,6 0x0000
position 5 4 0 0
parent map:25
sprite @5,3 sprite:wrestler (u32)0
sprite @11,7 sprite:samurai (u32)0
sprite @5,7 sprite:dancer (u32)0
sprite @11,3 sprite:ballplayer (u32)0
