2121212121212121212121212121212121212121
2121212121212121212121212121212121212121
2121211331313131313131313131313114212121
2121212207040107050607000701040020212121
2121212204020306060107070002050620212121
2121212201060506070706030406010220212121
2121212201070106010004020305010620212121
2121212203050704040600020005020020212121
2121212201040100020606000600050520212121
2121212311111111111108111111111124212121
2121212121212121212121212121212121212121
2121212121212121212121212121212121212121

image image:fractia_int
door @10,9 map:26 @6,6 0x0000
position 2 4 0 0
parent map:26
sprite @14,4 sprite:jigpiece (u32)0
sprite @6,4 sprite:doctor (u32)0
sprite @5,7 sprite:fractia_nurse (u32)0
sprite @12,5 sprite:secretary (u32)0
sprite @14,7 sprite:clerk (u32)0
