2121212121212121212121212121212121212121
2121212121212121212121212121212121212121
2121211331313131313131313131313114212121
2121212207040107050607000701040020212121
2121212204020306060107070002050620212121
2121212201060506070706030406010220212121
2121212201070104070004020305010620212121
212121220305030a020600020005020020212121
2121212201040605000606000600050520212121
2121212311111111111108111111111124212121
2121212121212121212121212121212121212121
2121212121212121212121212121212121212121

image image:fractia_int
door @10,9 map:26 @6,6 0x0000
position 2 4 0 0
parent map:26
stompbox @7,7 (u16:fld)endorse_hospital
sprite @14,4 sprite:jigpiece (u32)0
