c4b6d4d505030005c3c4c4c506030306d3d4b7c4
d4d5d0b200060004d3d4d4d505030501b0c2d3d4
d1c2000306060406c0e0e1d2000600000001b0b1
0604040600050501016062050004050004000204
0002050203030300506463515152010501050104
0400505151515151645371715463515203020604
0301707171717171717206027071717205020300
0304030506050302050002030505030102000103
0605060006060600058081818182000505030500
8182000001030005809491919193820204040402
9193818181818181949191919191938206040003
9191919191919191919191919191919381818181

image image:tundra
position 2 1 1 *
sprite @6,4 sprite:jigpiece (u32)0
door @9,2 map:324 @10,8 0x0000
door @10,2 map:324 @10,8 0x0000
