0305050504020602020600606203000090919191
0503050506040604040001606201020390919191
0404060204010102030104606200020390919191
0506040103000603050100606203010090919191
0501010501000602060501606200050690919191
5151515151515151515151646200020390919191
7171717171717171717171717204040390919191
0200010102010604000202020604040490919191
0002040606030001060402010502060690919191
0404000106030103010100050104030090919191
0003010106050000010201040606000090919191
8181818181818181811581818181818194919191

image image:meadow
position 2 2 1 *
song song:snowglobe
sprite @14,9 sprite:jigpiece (u32)0
