2121212122000020212121212121212121212121
2113313132000030313131313131313131311421
2122000000000000000000000000000000002021
2122000000000000000000000000000000002021
2122000000000000000000000000000000003031
3132000000000000000000000000000000000000
0043000000000000000000000000000000000000
0043000000000000000000000000000000001011
1112000000000000000203020000000000002021
2122000000000000000202010000000000002021
2123111111111111111203101111111111112421
2121212121212121212311242121212121212121

image image:temple_int
door @10,10 map:43 @1,9 (u16:activity)unoverride_outerworld_song
parent map:43
position 2 3 5 0
song song:minotaur
switchable @1,7 (u16:fld)undemo
