2121212121212121212121212121212121212121
2121212121212113313131313131313131311421
2121212121212122050000000000000000002021
2121212121212122000000000000000000002021
3131313131142123120010111111111204102421
0000000000202121220020212121212311242121
0000000000303142320020212121212121212121
1112000000000000000020212121212121212121
2122000000000000000020212121212121212121
2122000000000000000020212121212121212121
2123111111111111111124212121212121212121
2121212121212121212121212121212121212121

image image:temple_int
position 3 2 5 *
parent map:43
door @16,4 map:43 @9,4 0x0000
sprite @9,4 sprite:escalator (u8)3 (u24)0
bump @7,6 (u16)0 strings:dialogue (u16)85
song song:minotaur
door @8,2 map:196 @8,8 0x0000
