2121212121212121212200002021212121212121
2113313131313131313200003031313131311421
3132000000000000000000000000000000002021
0000000000000000000000000000000000002021
0000000000000000000000000000000000002021
1112000000000000000000000000000000002021
2122000000000000000000000000000000002021
2122000000000000000000000000000000002021
2122000000000000000000000000000000002021
2122000000000000000000000000000000002021
2123111111111111111111111111111111112421
2121212121212121212121212121212121212121

image image:temple_int
position 3 1 5 *
parent map:43
