2121212121212121212121212121212121212121
2113313131141331313114133131311421212121
2122030301202202010220220102032021212121
2122030203202202020320220303032013313131
2122030103202201010220220201012022000000
2123120110242312031024231203102422001011
3131320130313132013031313201303132022021
0203010301010103030302030102010103032021
1201020301030303020101030202030302032021
2311111112010310111111111111111111112421
2121212122020220212121212121212121212121
2121212122010120212121212121212121212121

image image:temple_int
position 2 1 5 *
parent map:43
sprite @13,3 sprite:monk4 (u16:activity)statuemaze_clue (u16:activity_arg)3
sprite @3,3 sprite:monk2 (u16:activity)statuemaze_clue (u16:activity_arg)1
sprite @8,3 sprite:monk3 (u16:activity)statuemaze_clue (u16:activity_arg)2
