2121212122000020212121212121212121212121
2121212122000020212121212121212121212121
2121133132000030311421212121212121212121
2121220000000000002021212121212121212121
3131320010111112003031313131313131313131
0000000020212122000000000000000000000000
0000000020212122000000000000000000000000
1111120030404132001011111111111111111111
2121220000000000002021212121212121212121
2121231112000010112421212121212121212121
2121212122000020212121212121212121212121
2121212122000020212121212121212121212121

image image:temple_int
position 2 2 5 *
parent map:43
bump @6,7 (u16)0 strings:dialogue (u16)84
bump @5,7 (u16)0 strings:dialogue (u16)84
