2121212121212121212121212121212121212121
2121212121133131313131313114212121212121
2121212121220708090a0b0c0d20212121212121
2121212121221718191a1b1c1d20212121212121
2121212121222728292a2b2c2d20212121212121
2121212121220000003a00000030313131313131
2121212121220000000000000000000000000000
2121212121220000000000000000000000000000
2121212121220000000000000010111111111111
2121212121231111111111111124212121212121
2121212121212121212121212121212121212121
2121212121212121212121212121212121212121

image image:temple_int
position 1 3 5 *
parent map:43
sprite @11,5 sprite:monk1 (u16:activity)dialogue (u16:activity_arg)86
bump @9,5 (u16:activity)crocodile (u16)0 (u16)0
