3135312531253535313525253125353131252531
3125353531253535352535253525252535252531
3525313525253525313125313125253125252531
3131353131353525252531312535252525253131
4124353525353525234141414124312535253525
0240414124312525320506030440412435313131
0302020340243531320101010106004041414141
0405000406404124332205040204020605010504
0104040400010140414203050000000603060400
0403060006020205000505030604050105000101
0000040002050602060202050401030001010204
0000000506060400020603050402000401060005

image image:tundra
position 3 0 1 *
sprite @9,5 sprite:jigpiece (u32)0
