4141414141414141414141414141414141414141
0600000100040504000300060606020402020600
0500000405000001060000020303050601060400
0401040601040200000503030401060201010204
0102040006060300000005060406020403030300
0206050300040601040002030403060000060506
0602020501060406440003010500010201000600
0405000000040305434504040204040300020600
0104040406030101060600050000000603060400
0403060006020302030100030604050105000101
0000040002050602060202050401030001010204
0000000506060400020603050402000401060005

image image:meadow
position 3 0 1 *
sprite @9,6 sprite:jigpiece (u32)0
