2121212121212121212121212121212121212121
2113313131313131313131313131313131311421
2122000000000000000000000000000000002021
2122000000000000343300000000000000002021
2122000000000033000034000000000000002021
2122000000000000000034000000000000002021
2122000000000000343300000000000000002021
2122000000000000000000000000000000002021
2122000000000000333300000000000000002021
2122000000000000000000000000000000002021
2123111111111111111111111111111111112421
2121212121212121212121212121212121212121

image image:temple_int
position 0 3 5 *
parent map:43
