2121212121212121212121212121212121212121
2121212121212121212121212121212121212121
2121133131313131313131313131313114212121
2121220000000000000000000000000020212121
2121220000000000000000000000000030313131
3131320000000000000000000000000000000000
0000000000000000000000000000000000000000
1111120000000000000000000000000010111111
2121220000000000000000000000000020212121
2121220000000000000000000000000020212121
2121231111111111111111111111111124212121
2121212121212121212121212121212121212121

image image:temple_int
position 1 2 5 *
parent map:43
sprite @2,6 sprite:statuemaze (u32)0
cameralock
statuemaze @5,4
