2121212121212121212121212121212121212121
2121212121212121212121212121212121212121
2121212121212121212121212121212121212121
2121212121212121212121212121212121212121
2121212121212121212121212121212121212121
2121212121212121212121212121211331313114
2121212121212121212121212121212201030230
2121212121212121212121212121212202020102
2121212121212121212121212121212203030110
2121212121212121212121212121212311111124
2121212121212121212121212121212121212121
2121212121212121212121212121212121212121

image image:temple_int
position 1 1 5 *
parent map:43
sprite @17,7 sprite:monk1 (u16:activity)statuemaze_clue (u16:activity_arg)0
