2121212121212121212121212121212121212121
2113313131313131313131313131313131311421
2122000000000000000000000000000000002021
2122000000000000000000000000000000002021
2122000000000000000000000000000000002021
2122000000000000000000000000000000003031
2122000000000000000000000000000000000000
2122000000000000000000000000000000000000
2122000000000000000000000000000000001011
2122000000000000000000000000000000002021
2123111111111111111111111111111111112421
2121212121212121212121212121212121212121

image image:temple_int
position 1 1 5 *
parent map:43
