2121212121212121212121212121212121212121
2121133131313131313131313131313131311421
2121220000000000000000000000000000002021
2121220033003333000000000033330033002021
2121220033000033003434340033000033002021
2121220033330033000000000033003333002021
2121220000000000003405340000000000002021
2121220033330033000000000033003333002021
2121220033000033003434340033000033002021
2121220033003333000000000033330033002021
2121220000000000000000000000000000002021
2121231111111111111200101111111111112421

image image:temple_int
position 0 1 5 *
parent map:43
door @10,6 map:187 @10,6 0x0000
