2121212121212121212121212121212121212121
2121212121212121212121212121212121212121
2113313131311413313131311413313131311413
2122020301032022030102032022020201032022
2122030101032022030201032022010101032022
2122020302032022020302012022010201022022
2123111112032023120210112423111203102423
2121211332013031320130313131313201303131
2121212201020201030301020201020201030302
2121212203020201030103020202020202020102
2121212311111111111111111111111111111111
2121212121212121212121212121212121212121

image image:temple_int
position 0 0 5 *
parent map:43
sprite @3,4 sprite:monk2 (u16:activity)dialogue (u16:activity_arg)86
sprite @15,4 sprite:monk1 (u16:activity)dialogue (u16:activity_arg)87
