2121212121212121212121212121212121212121
2121212121212121212121212121212121212121
2121212121212121212121212121212121212121
2121212121212121212121212121212121212121
2121212121212121212121212121212121212121
2121212121212121212121212121212121212121
2121212121212121212121212121212121212121
2121211331313131313131313131313131313131
2121212203030203030302010201010103030302
2121212203020201030103020202020202020102
2121212311111111111111111111111111111111
2121212121212121212121212121212121212121

image image:temple_int
position 0 0 5 *
parent map:43
