2121212121212121212121212121212121212121
2121212121212121212121212121212121212121
3131313114133131313114133131313114133131
0301010320220103030120220202030220220303
0103020320220203030320220301030320220302
0101030220220303020320220202010220220303
1112021024231201101124231112031024231111
3132033031313202303131313132033031313131
0202030301020302010203030301010103010302
0302010202010303030301030303010303020202
1111111111111111111111111111111111111111
2121212121212121212121212121212121212121

image image:temple_int
position 1 0 5 *
parent map:43
sprite @8,4 sprite:monk4 (u16:activity)statuemaze_clue (u16:activity_arg)2
sprite @13,4 sprite:monk3 (u16:activity)statuemaze_clue (u16:activity_arg)3
