2121212121212121212121212121212121212121
2121212121212121212121212121212121212121
2121212121212121212121212121212121212121
2121212121212121212121212121212121212121
2121212121212121133131313131313131313131
2121212121212121220000000000000000000000
2121212121212121220002000300000000000000
2121212121212121220000000000000000000000
2121212121212121220000000000000000000000
2121212121212121220000000015160000000015
2121212121212121220000000025260000000025
2121212121212121220000000000000000000000

image image:labyrinth
door @10,6 map:184 @10,6 0x0000
position 0 0 4 0
sprite @16,7 sprite:jigpiece (u32)0
bump @12,6 (u16)0 strings:dialogue (u16)90
pylon @13,9
