2121212121212121212121212121212121212121
2121212121212121212121212121212121212121
2121212121212121212121212121212121212121
2121212121212121212121212121212121212121
3131313131313131313131070809313131313131
0000000000000000000000171819000000000000
0000000000000000000000000000000000000000
0000000000000000000000000000000000000000
0000000000000000000000000000000000000000
0000001516000000001516000000001516000000
0000002526000000002526000000002526000000
0000000000000000000000000000000000000000

image image:labyrinth
position 2 0 4 *
sprite @6,7 sprite:jigpiece (u32)0
dark
sprite @18,7 sprite:firepot (u8:radius_m)3 (u24)0
sprite @7,8 sprite:firepot (u8:radius_m)3 (u24)0
rspriteres rsprite:labyrinth
bump @12,5 (u16:activity)brewer_single (u16)2 (u16)0
