0604020004040000060300040602010002040600
0000000000050506060206050105020205060303
0505030205000604040003050201060506000200
0202000203010100000201454401020004060105
0605010001030406054444040443430005000600
0505040005010500054400050502450300030400
0005060301020602004506000103440505000606
0606030303010306060201030601000106060404
0602060003010006010206020306060100050506
0005060500060005040500040204010600040200
0201050202010300040000060305010202050505
0001030200060505020502000002010000010604

image image:meadow
position 3 1 1 *
