0200000004060204010103020201040206000404
0600000501030604010001000102030000020001
0102060001010502010304020506060003050304
06000103020405a4020302060003020306020106
05050600050203a4020105060606030106060203
02010000020606a3030002060506060303060605
00020005060600a4a3a406020001060502060405
0400020302030406020604000200030101020002
0401020606040002060302030104010102030004
0202000002030400050406010306040100010401
0106060504000301040402050401040301030403
0105010200010602000004010005010403000505

image image:meadow
position -2 -3 1 *
