0401020506030601030406000006030006050402
0604040606000302060206030100030005010205
0202040606050105000101010505030400030206
0105020000120601060106030600000313060502
0106060406000400010604040202030000040502
0006050404030004010005050301000000040004
0000040401010106110403060101020000030105
0403030601030103030203030402050400030103
0501050000050506010605100601050202020601
0201020405040304010200030400010401040202
8181820300060103000200010306020505030600
9191920300040003020001030200030303040000

image image:meadow
position 3 0 1 *
sprite @11,4 sprite:jigpiece (u32)0
