2121212121212121212121212121212121212121
2121212121212121212121212121212121212121
2121212121212121212121212121212121212121
2121212121212121212121212121212121212121
3131313131313131313131313131313131313131
0000000000000000000000000000000000000000
0000000000000000000000000000000000000000
0000000000000000000000000000000000000000
0000000000000000000000000000000000000000
0000000000000000000000000000000000000000
1112000000000000101111120000000000001011
2122000000000000202121220000000000002021

image image:labyrinth
position 3 0 4 *
sprite @5,6 sprite:jigpiece (u32)0
