2121212121212121212121212121212121212121
2121212121212121212121212121212121212121
2121212121212121212121212121212121212121
2121212121212121212121212121212121212121
3131313131313131313131313131313131313131
0000000000000000000000000000000000000000
0000000000000000000000000000000000000000
0000000000000000000000000000000000000000
0000000000000000000000000000000000000000
0015160000000015160000000015160000000015
0025260000000025260000000025260000000025
0000000000000000000000000000000000000000

image image:labyrinth
position 3 0 4 *
sprite @5,6 sprite:jigpiece (u32)0
