2121212121212121212121212121212121212121
2121212121212121212121212121212121212121
2121212121212121212121212121212121212121
2121212121212121212121212121212121212121
3131313131313131313131313131313131311421
0000000000000000000000000000000000002021
0000000000000000000000000000000000002021
0000000000000000000000000000000000002021
0000000000000000000000000000000000002021
0000000000000000000000000000000000002021
1112000000000000000000000000000000002021
2122000000000000000000000000000000002021

image image:labyrinth
position 4 0 4 *
sprite @12,6 sprite:jigpiece (u32)0
