2121212121212121212121212121212121212121
2121212121212121212121212121212121212121
2121212121212121212121212121212121212121
2121212121212121212121212121212121212121
3131313131313131311421212121212121212121
0000000000000000002021212121212121212121
0000000000030002002021212121212121212121
0000000000000000002021212121212121212121
0000000000000000002021212121212121212121
0000001516000000002021212121212121212121
0000002526000000002021212121212121212121
0000000000000000002021212121212121212121

image image:labyrinth
position 5 0 4 *
door @7,6 map:173 @8,2 0x0000
sprite @2,5 sprite:jigpiece (u32)0
bump @5,6 (u16)0 strings:dialogue (u16)90
