0000000000000000002021212121212121212121
0000000000000000002021212121212121212121
0000000000000000002021212121212121212121
0000001516000000002021212121212121212121
0000002526000000002021212121212121212121
0000000000000000002021212121212121212121
0000000000000000002021212121212121212121
0000000000000000002021212121212121212121
0000000000000000002021212121212121212121
0000001516000000002021212121212121212121
0000002526000000002021212121212121212121
0000000000000000002021212121212121212121

image image:labyrinth
position 5 1 4 *
sprite @7,6 sprite:jigpiece (u32)0
