2122000000000000000020212121212121212121
3132000000000000000020212121212121212121
0000000000000000000020212121212121212121
0000000000000000000020212121212121212121
0000000000000000000020212121212121212121
0000000000000000000020212121212121212121
0000000000000000000020212121212121212121
1111111111111111111124212121212121212121
2121212121212121212121212121212121212121
2121212121212121212121212121212121212121
2121212121212121212121212121212121212121
2121212121212121212121212121212121212121

image image:labyrinth
position 5 4 4 *
sprite @6,3 sprite:jigpiece (u32)0
