0000000000000000002021212121212121212121
0000000000000000002021212121212121212121
0000000000000000002021212121212121212121
0000001516000000002021212121212121212121
0000002526000000002021212121212121212121
0000000000000000002021212121212121212121
0000000000000000002021212121212121212121
0000000000000000002021212121212121212121
0000000000030000022021212121212121212121
1111111111111111112421212121212121212121
2121212121212121212121212121212121212121
2121212121212121212121212121212121212121

image image:labyrinth
position 5 4 4 *
sprite @7,1 sprite:jigpiece (u32)0
dark
sprite @6,6 sprite:firepot (u8:radius_m)3 (u24)0
bump @5,8 (u16)0 strings:dialogue (u16)90
door @8,8 map:173 @8,2 (u16:activity)escape_labyrinth
