2121212121212121220000000000000000000000
2121212121212121220000000000000000000000
2121212121212121220000000000000000000000
2121212121212121220000000015160000000015
2121212121212121220000000025260000000025
2121212121212121220000000000000000000000
2121212121212121220000000000000000000000
2121212121212121220000000000000000000000
2121212121212121220000000000000000000000
2121212121212121220000000015160000000015
2121212121212121220000000025260000000025
2121212121212121220000000000000000000000

image image:labyrinth
position 0 3 4 *
sprite @11,6 sprite:jigpiece (u32)0
dark
sprite @16,6 sprite:firepot (u8:radius_m)3 (u24)0
rspriteres rsprite:labyrinth
