2121212121212121220000000000000000002021
2121212121212121220000000000000000003031
2121212121212121220000000000000000000000
2121212121212121220000000000000000000000
2121212121212121220000000000000000000000
2121212121212121220000000000000000000000
2121212121212121220000000000000000000000
2121212121212121220000000000000000000000
2121212121212121220000000000000000000000
2121212121212121220000000000000000000000
2121212121212121220000000000000000001011
2121212121212121220000000000000000002021

image image:labyrinth
position 0 3 4 *
sprite @13,6 sprite:jigpiece (u32)0
