2341414142060203040202404141414141414124
3203040006050302050103000600010202010630
3200050200030203020406040301040504020230
3203030306030101060505020206000406000230
3200030205010403040403020403050104050130
3200060400000202000302030201060603030530
3206040006060405060200020304030606010130
3200020303020602040406020605030401050430
3204030104010300040401050600050603030530
3205050106000001030602000300040305000330
3201060103030400000000040105020105040130
3321212121212122000202040120212121212134

image image:meadow
position 0 -1 1 *
sprite @7,4 sprite:leopard (u32)0
sprite @16,7 sprite:jigpiece (u32)0
