0000000000000000000000000000000000000000
0000000000000000000000000000000000000000
0000000000000000000000000000000000000000
0000000000000000000000000000000000000000
0000000000000000000000000000000000000000
1c0000000000003e00000000000000000000001a
2c0000000000003e00000000000000000000002a
2c0000000000003d3e3d0000000000000000002a
2c0000000000000000000000000000000000002a
2c0000000000000000000000000000000000002a
2c0000000000000000000000000000000000002a
2d1b1b1b1b1b1b1b1b1b1b1b1b1b1b1b1b1b1b2e

image image:meadow
position -2 -2 1 *
