9191920304060006040605010106060106000003
9191920300050303050001060401030505060502
9183a20200020401000604040500000001040406
83a2030300040000040605030400010402040306
a203060402000044050002060002010004030106
0104010101060443040303000006000200030000
0400020000000545030002000200060501060604
0000010402010504434343434504010504060500
0505000202040400020306010201000200030103
0106040404010205000600030100010502030602
0500000000050004060504030502808182000402
0000010106008081818181818181949193818181

image image:meadow
position 3 2 1 *
sprite @10,5 sprite:jigpiece (u32)0
