0404050602000005020003000601010202000690
0401020101060606040406000403050406030090
0601030402060002050306050400060606030090
0604000201051001000200060100020304120390
0606020606060203030101050503030503000090
0402000202010304060502020505040104060290
0301030406040603000204050201050401060190
0206000501040405130506060304020005100090
0505120406000100020601010311060000060390
0601000005050203030606030405030303010590
0500060603030200010006060605020105030090
0005040003040603020204060601040405050190

image image:meadow
position 4 0 1 *
sprite @10,5 sprite:jigpiece (u32)0
song song:nearer_the_sky
