2122000000000000000000000000000000002021
3132000000000000000000000000000000003031
0000000000000000000000000000000000000000
0000000000000000000000000000000000000000
0000000000000000000000000000000000000000
0000000000000000000000000000000000000000
0000000000000000000000000000000000000000
1111111111111111111111111111111111111111
2121212121212121212121212121212121212121
2121212121212121212121212121212121212121
2121212121212121212121212121212121212121
2121212121212121212121212121212121212121

image image:labyrinth
position 1 4 4 *
sprite @8,2 sprite:jigpiece (u32)0
