0000000000000000000000000000000000000000
0000000000000000000000000000000000000000
0000000000000000000000000000000000000000
0000001516000000001516000000001516000000
0000002526000000002526000000002526000000
0000000000000000000000000000000000000000
0000000000000000000000000000000000000000
0000000000000000000000000000000000000000
0000000000000000000000000000000000000000
1111111111111111111111111111111111111111
2121212121212121212121212121212121212121
2121212121212121212121212121212121212121

image image:labyrinth
position 2 4 4 *
sprite @6,6 sprite:jigpiece (u32)0
dark
sprite @18,2 sprite:firepot (u8:radius_m)3 (u24)0
sprite @7,6 sprite:firepot (u8:radius_m)3 (u24)0
rspriteres rsprite:labyrinth
