0000000000000000000000000000000000000000
0000000000000000000000000000000000000000
0000000000000000000000000000000000000000
0015160000000015160000000015160000000015
0025260000000025260000000025260000000025
0000000000000000000000000000000000000000
0000000000000000000000000000000000000000
0000000000000000000000000000000000000000
0000000000000000000000000000000000000000
1111111111111111111111111111111111111111
2121212121212121212121212121212121212121
2121212121212121212121212121212121212121

image image:labyrinth
position 3 4 4 *
sprite @5,1 sprite:jigpiece (u32)0
