2122000000000000202121220000000000002021
3132000000000000303131320000000000003031
0000000000000000000000000000000000000000
0000000000000000000000000000000000000000
0000000000000000000000000000000000000000
0000000000000000000000000000000000000000
0000000000000000000000000000000000000000
1111111111111111111111111111111111111111
2121212121212121212121212121212121212121
2121212121212121212121212121212121212121
2121212121212121212121212121212121212121
2121212121212121212121212121212121212121

image image:labyrinth
position 3 4 4 *
sprite @5,4 sprite:jigpiece (u32)0
