2122000000000000000000000000000000002021
3132000000000000000000000000000000003031
0000000000000000000000000000000000000000
0000000000000000000000000000000000000000
0000000000000000000000000000000000000000
0000000000000000000000000000000000000000
0000000000000000000010111111111111111111
1111111111111111111124212121212121212121
2121212121212121212121212121212121212121
2121212121212121212121212121212121212121
2121212121212121212121212121212121212121
2121212121212121212121212121212121212121

image image:labyrinth
position 4 4 4 *
sprite @9,4 sprite:jigpiece (u32)0
