2122000000000000000000000000000000002021
3132000000000000000000000000000000003031
0000000000000000000000000000000000000000
0000000000000000000000000000000000000000
0000000000000000000000000000000000000000
0000000000000000000000000000000000000000
0000000000000000000000000000000000000000
0000000000000000000000000000000000000000
0000000000000000000000000000000000000000
0000000000000000000000000000000000000000
1112000000000000000000000000000000001011
2122000000000000000000000000000000002021

image image:labyrinth
position 4 3 4 *
sprite @7,6 sprite:jigpiece (u32)0
