9191920404040506020004040005010000060100
9191920006020206030201060404050300010105
9191920500000301000200000504000400040601
9191920100000205000600020606040306040506
9191938205000005030101020004004403050300
9191919200040101030001010602014301030003
9191919382434401040001020300440202020300
9191919192034344454544440444450400020106
9191919193820201000106030500020303010200
9191919191938181818203000506030302060200
9191919191919191919381818182020303060400
9191919191919191919191919193820500000400

image image:meadow
position 4 3 1 *
sprite @9,4 sprite:jigpiece (u32)0
