2122000000000000202121220000000000002021
3132000000000000303131320000000000003031
0000000000000000000000000000000000000000
0000005051515200000000000000000000000000
0000506461616352000000000000000000000000
0000606161616162000000000000000000000000
0000606161616162000000000000000000000000
0000705461615372000000000000000000000000
0000007071717200000000000000000000000000
0000000000000000000000000000000000000000
1112000000000000101111120000000000001011
2122000000000000202121220000000000002021

image image:labyrinth
position 2 3 4 *
sprite @14,6 sprite:jigpiece (u32)0
