2121212121212121212121212121212121212121
3131313131313131313131313131313131313131
0000000000000000000000000000000000000000
0000000000000000000000000000000000000000
0000000000000000000000000000000000000000
0000000000000000000000000000000000000000
0000000000000000000000000000000000000000
0000000000000000000000000000000000000000
0000000000000000000000000000000000000000
0000000000000000000000000000000000000000
1112000000000000000000000000000000001011
2122000000000000000000000000000000002021

image image:labyrinth
position 1 1 4 *
sprite @9,6 sprite:jigpiece (u32)0
