0000000000000000000000000000000000000000
0000000000000000000000000000000000000000
0000000000000000000000000000000000000000
1600000000151600000000151600000000151600
2600000000252600000000252600000000252600
0000000000000000000000000000000000000000
0000000000000000000000000000000000000000
0000000000000000000000000000000000000000
0000000000000000000000000000000000000000
1600000000151600000000151600000000151600
2600000000252600000000252600000000252600
0000000000000000000000000000000000000000

image image:labyrinth
position 1 3 4 *
sprite @4,6 sprite:jigpiece (u32)0
dark
sprite @9,6 sprite:firepot (u8:radius_m)3 (u24)0
rspriteres rsprite:labyrinth
