3135313525320101303525312535313531353535
3125352535320404302535312525313125253125
2531234141420600404141243125353535352525
4141420105010205040403402425313531252525
0200060000040102040403024041242525313531
0202060500030500060405010302404141414141
0300050602000004060401030400030300020605
0405000501000500010100010300050204010206
0000010003000206060000010604060104050006
0006050500040505040300020202000500000002
0201000501000405030502000304010304020105
8181820602020505030005040106040306040001

image image:meadow
position 4 2 1 *
sprite @10,6 sprite:jigpiece (u32)0
