0100050102060500010102030305060503000005
0000060600060105040302030003030401040204
0600050205000405000006020104010502010202
0104000001010001050601050200040001060500
0205000200020404434544004345010002040004
0202060502034344050200000600010201050602
0300050200440602000401030405000102000402
0405000443430606010100010300050204010206
0000010600020006060000010604060104050006
0006050500040505040300020202000500000002
0201000501000405030502000304010304020105
8181820602020505030005040106040306040001

image image:meadow
position 4 2 1 *
sprite @10,6 sprite:jigpiece (u32)0
