5151515151515151515151515151515151515151
5151515151515151515151515151515151515151
5151515143616161616161616161445151515151
5151515152000200030400000104505151515151
5151515152010601010100000005505151515151
5151515152050606000000000007505151515151
5151515152070204000000000001505151515151
51515151520c0604070507000704505151515151
5151515153414141420140414141545151515151
5151515151515151534154515151515151515151
5151515151515151515151515151515151515151
5151515151515151515151515151515151515151

image image:fractia_int
door @9,8 map:58 @9,6 0x0000
parent map:58
position 9 3 0 0
door @5,7 map:268 @5,7 0x0000
