5151515151515151515151515151515151515151
5151515151515151515151515151515151515151
5151515143616161616161616161445151515151
5151515152000300060400000104505151515151
5151515152010000000100000005505151515151
5151515152050000000000000007505151515151
5151515152050000000000000001505151515151
5151515152010300010507000704505151515151
5151515153414141420140414141545151515151
5151515151515151534154515151515151515151
5151515151515151515151515151515151515151
5151515151515151515151515151515151515151

image image:fractia_int
door @9,8 map:58 @9,6 0x0000
parent map:58
position 9 3 0 0
sprite @7,4 sprite:treasure (u8:itemid)stopwatch (u8:quantity)0 (u16:fld)0
sprite @11,4 sprite:treasure (u8:itemid)tapemeasure (u8:quantity)0 (u16:fld)0
