5151515151515151515151515151515151515151
5151515151515151515151515151515151515151
5151515151514361616161616144515151515151
5151515151515205060205010050515151515151
5151515151515204000000000450515151515151
5151515151515207000000000750515151515151
5151515151515201040101040350515151515151
5151515151515341414205404154515151515151
5151515151515151515341545151515151515151
5151515151515151515151515151515151515151
5151515151515151515151515151515151515151
5151515151515151515151515151515151515151

image image:fractia_int
door @10,7 map:25 @7,0 0x0000
parent map:25
position 11 3 0 0
