2121212121212121212121212121212121212121
2121212121212121212121212121212121212121
2121212121212121212121212121212121212121
2121212121212121212121212121212121212121
3131313131311413313114133131141331313114
0402020100013032060030320505303205040430
0506000501060403030401070002000307040000
1112020100060306060500000707000705040207
2123111206030000050600030003070304070010
2121212311120501030405080606020505061024
2121212121231111120507030006040210112421
2121212121212121231111111111111124212121

image image:caves
position 2 0 2 *
sprite @13,5 sprite:jigpiece (u32)0
door @11,9 map:341 @8,4 0x0000
