2113313131313131313131313131313131311421
2122a0a0a0a0a0a0a0a0a0a0a0a0a0a0a0a02021
13b0a0a0a0a0a0a0a0a0a0a0a0a0a0a0a0a02021
22c0a0a0a0a0a0a0a0a0a0a0a0a0a0a0a0a03014
2205a0a0a0a0a0a0a0a0a0a0a0a0a0a0a0a00020
3203a0a0a0a0a0a0a0a0a0a0a0a0a0a0a0a00030
0503a0a0a0a0a0a0a0a0a0a0a0a0a0a0a0a00507
0104a0a0a0a0a0a0a0a0a0a0a0a0a0a0a0a00604
1201a0a0a0a0a0a0a0a0a0a0a0a0a0a0a0a00510
2200a0a0a0a0a0a0a0a0a0a0a0a0a0a0a0a00020
2312a0a0a0a0a0a0a0a0a0a0a0a0a0a0a0a01024
212311111111124e4e1011111111111111112421

image image:caves
position 3 0 2 *
sprite @1,9 sprite:jigpiece (u32)0
sprite @2,1 sprite:minesweeper (u16:fld)minesweep1 (u16)0
cameralock (u16:fld)minesweep1
switchable @8,11 (u16:fld)minesweep1
switchable @7,11 (u16:fld)minesweep1
bump @1,2 (u16:activity)reset_puzzle (u16:fld)minesweep1 (u16)0
