1331313131313131313131313131313131313114
2201060707010406040405020507000307030020
2204000000000000000000000000000000000220
2203000000000004010702020000000000000620
2205000000000002340334030000000000000330
3201000000000004343434050000000000000504
0006000000000006050534020000000000000000
0407000000000000000405000000000000000004
1203000000000000000000000000000000000410
2201000000000000000000000000000000000720
2206000607000705000000010503060503010420
2311111111111112010000051011111111111124

image image:caves
position 4 0 2 *
sprite @13,2 sprite:jigpiece (u32)0
