1331313131313131313131313131313131313114
2206010000000205050101010505040202000620
2206010301060101040407060506040405020020
2205010601040501020007070105050206060020
2201000033330333330733330604330004070130
3205010033013303330533033302330400000003
0102020033060104330533040433330706070606
0004050707040307030600030302050002040605
1204050105000102010503040001070500020110
2207010301040103010004020503010205060120
2204030607070603030402000406010506020020
2311111111111111120001101111111111111124

image image:caves
position 4 0 2 *
sprite @13,2 sprite:jigpiece (u32)0
