1331313131313131313131313131313131313114
2206010000000205050101010505040202000620
2206010301060101040407060501070707020020
2205010400020507050400010600040200060330
2201000307050502070600020607000602070104
3205010105060503000604020101060104000600
0102020604030301010000070204040304070606
0004050101040302060202070403050202040605
1204050105000102010503040001070500020110
2207010301040103010004020503010205060120
2204030607070603030403070505010506020020
2311111111111111120003050610111111111124

image image:caves
position 4 0 2 *
sprite @13,2 sprite:jigpiece (u32)0
sprite @9,5 sprite:moonsong (u16:activity)moonsong race:undernorth
race @12,6 6 0
track @13,7 6 0
rspriteres rsprite:unorth
