2121212121212121212121212121212121212121
2121212121212121212121212121212121212121
2121212121212121212121212121212121212121
3131313114212121212121212121211331313131
0703060530313114212121211331313202010503
0602030606010330313131313205030707060207
0004060203040602040303010104030507070707
0203020604000506010403060101070706020002
1111120707010203020207040502050404101111
2121231112040100060601070307001011242121
2121212123111204020500020210112421212121
2121212121212311120407101124212121212121

image image:caves
position 5 0 2 *
sprite @3,8 sprite:jigpiece (u32)0
track @3,6 6 1
track @9,10 6 2
track @18,5 6 3
rspriteres rsprite:unorth
