2121212121212121212121212121212121212121
2121212121212121212121212121212121212121
2121212121212113313131311421212121212121
2121212121133132050602053031142121212121
3131313131320406030701020106303131313131
0001070406040705020406070600030101070407
0200010504040210120007101204050003030000
0005030510111124220404202311111201010506
1111111124212121220003202121212311111111
2121212121212121220000202121212121212121
2121212121212121220206202121212121212121
2121212121212121220307202121212121212121

image image:caves
position 6 0 2 *
sprite @9,5 sprite:jigpiece (u32)0
