0306040600000305050200020105020006040102
0303030601040000030001000105020304010103
0504020302050006020100020006060605000201
0502050003050006040100030501000403040501
0203000305000104010205040502020202000405
0403010402020603030405430604030502040000
0000050104030501010445450002010001030004
0200010004010002454501030100000005020602
0006010501030000430500030102060402000400
0300000606030403000101020001000103030300
0502020504060204040000010102040603020306
0501020300010005010604000405000502000603

image image:meadow
position 4 1 1 *
sprite @6,4 sprite:jigpiece (u32)0
