9191919191919191919191919191919191919191
9191919191919191919191919191919191919191
9191919191919191919191919191919191919191
9191919191919191919191919191919191919191
9191919191919191919191919191919191919191
9191919191919191919191919191919191919191
9191919191919191919191919191919191919191
9191919191919191919191919191919191919191
9191919191919191919191919191919191919191
a1a1a1a1a1a1a1a1a1a1a1a1a1a1a1a1a1a1a1a1
0601050404000506030504060506030200050206
0602030304000004000300030100020102010003

image image:meadow
position -2 1 1 *
