0306040600000305050200020105020006040102
0303030601040000030001000105020304010103
0504020302050006020100020006060605000201
0502050003050006040100030501000403040501
0203000305000104010202050202020202000405
0403010402020603030500040406030502040000
0000050104030500010500000206010001030004
0200010004010001060400010405000005020602
0505000501030003010404040102060402000400
2122020206030401060501020001010602030205
3533212203000602040402050404052021212121
3135253321220504202121212121213431313125

image image:tundra
position 4 1 1 *
sprite @6,4 sprite:jigpiece (u32)0
