2121212121212121212121212121212121212121
2121212121212121212121212121212121212121
2121212121212121212121212121212121212121
2121212121212121212121212121212121212121
3131313131313131142121212121212113313131
0204000407030206303131142121212122050302
0101050600050400040305301421212122060403
0501040606000107020005013031142122031011
1112050403010701000401000000303132042021
2123111202000005040400010607030505052021
2121212311120302021011111111111111112421
2121212121231200032021212121212121212121

image image:caves
position 7 0 2 *
sprite @6,6 sprite:jigpiece (u32)0
