2121212121212121212121212121212121212121
2121212121212121212121212121212121212121
2121212121212121212121212121212121212121
3131313131142121212121212121212121212121
0202030404303131142121212121212113313131
0306010605070206303131142121212122050302
0101050600050400040305301421212122060403
0501040606000107020005013031142122031011
1112050403010701050307010000303132042021
2123111202060305070203040607030505052021
2121212312050203040705101111111111112421
2121212123120203040210242121212121212121

image image:caves
position 7 0 2 *
sprite @6,6 sprite:jigpiece (u32)0
track @7,8 6 6
rspriteres rsprite:unorth
surveyor (u16:fld16)surveyor_a
