1331313131313131313131313131313131313114
2207030507060007020604070505000704040520
2207000000000000000000000000000000000020
2207000000000003040506050000000000000120
3204000000000005333433000000000000000130
0302000000000002070033030000000000000406
0701000000000000000734000000000000000000
1203000000000000000302010000000000000402
2203000000000000000000000000000000000510
2205000000000000000000000000000000000120
2205000100000103000000000502060103070720
2311111111111207000000000610111111111124

image image:caves
position 7 0 2 *
