1331313131313131313131313131313131313114
2202070207060101070400020100030602010020
2204000000000000040407000000000000000120
2201000000000006023303030000000000000430
3204000000000006330133030000000000000401
0005000000000000023306000000000000000000
0000000000000001340033000000000000000407
0105000000000002073401040000000000000710
1206000000000000030303000000000000000420
2203000000000000000000000000000000000720
2202050402060201050605010300030706050720
2311111111111111111203071011111111111124

image image:caves
position 8 0 2 *
sprite @6,5 sprite:jigpiece (u32)0
