1331313131313131313131313131313131313114
2206020302000105030501070407040607030120
2202000000000000010701000000000000000420
3206000000000005063401050000000000000420
0604000000000004340634000000000000000320
0000000000000002033433040000000000000220
0207000000000000050433050000000000000220
1206000000000000000601020000000000000520
2206000000000000000000000000000000000120
2201000000000000000000000000000000000320
2204050602000507020004000002060204050720
2311111111111111111202000000101111111124

image image:caves
position 9 0 2 *
