2121212122070620212121212121212121212121
2121212122070020212121212121212121212121
2121212122060730142121212121212121212121
2121212122060206202121212121212121212121
2121212122040001301421212121212121212121
2121212122030604072021212121212121212121
2121212122030204042021212121212121212121
2121212122010601023014212121212121212121
2121212123120106030530142121212121212121
2121212121231206060207202121212121212121
2121212121212312020007202121212121212121
2121212121212122000001202121212121212121

image image:caves
position 0 4 2 *
sprite @6,6 sprite:jigpiece (u32)0
