2121212122070620212121211331313131313114
2121212122070020212121212207000501070720
2121212122060730142121212312070000000120
2121212122060206202121212122060000000320
2121212122040001301421212122000000000730
2121212122030604072021212122040000000302
2121212122030204042021212122040000000700
2121212122010601062021212122020700000510
2121212123120106063031142123120300000720
2121212121231206030003202121220406000520
2121212121212312020007202121231201060020
2121212121212122000001202121212311111124

image image:caves
position 0 4 2 *
sprite @16,5 sprite:jigpiece (u32)0
