2121212121212122020006202121212121212121
2121212121211332010007202121212121212121
2121212121212201070000202121212121212121
2121212121212201020103303131313114212121
2121212121212207060601040403040730313131
2121212121212312020706020006050404060202
2121212121212123111205020301060100000405
2121212121212121212311111112000700010010
2121212121212121212121212123120703011024
2121212121212121212121212121231111112421
2121212121212121212121212121212121212121
2121212121212121212121212121212121212121

image image:caves
position 0 5 2 *
sprite @11,4 sprite:jigpiece (u32)0
