2121212121212121212121212121212121212121
2121212121212121212121212121212121212121
2121212121212121212121212121212121212121
2121212121212121211331313131142121212121
2121212121212121212203020307303131311421
2121212121212121212203000007050407003031
2121212121212121133203000700070402020402
2121212121211331320001070610111206000205
2121212121212206000705071024212311111111
2121212121133204000604102421212121212121
2121212121220101010210242121212121212121
2121212121220100071024212121212121212121

image image:caves
position 0 6 2 *
sprite @7,8 sprite:jigpiece (u32)0
