1331313131313131313132000330313131313114
2204060006030307020700060606040606010420
2200343434340007000501343434343434340420
2201340000000434333305000000000000000620
2206340000000534010400000000000000000220
2205340000000133343404000000000000000630
2206340000000633033401000000000000000400
2203340000000134333307000000000000000205
2203340000000305070200000000000000000610
2203340000000000000000000000000000000420
2201030405070500010302070602030607050120
2311111111120400071011111111111111111124

image image:caves
position 0 6 2 *
