2121212121212121212122070420212121212121
2121212121212121211332010720212121212121
2121212121212121212203050030142121212121
2121212121212121212200010407202121212121
2121212121212121212205000003201331311421
2121212121212121212203000003202204003031
2121212121212121133203000706202201020402
2121212121211331320001070610242205000205
2121212121212206000705071024212311111111
2121212121133204000604102421212121212121
2121212121220101010210242121212121212121
2121212121220100071024212121212121212121

image image:caves
position 0 6 2 *
sprite @7,8 sprite:jigpiece (u32)0
