2121212121220704002021212121212121212121
2121211331320404012021212121212121212121
2121212205040304102421212121212121212121
2121212200030605202121212121212121212121
2121212206020205202121133131313131313131
2121212312060103202113320701000306010303
2121212122060301202122070705070505060701
2121212122020802202122020303031011111111
2121212123111111242123120200102421212121
2121212121212121212121231111242121212121
2121212121212121212121212121212121212121
2121212121212121212121212121212121212121

image image:caves
position 0 7 2 *
door @6,7 map:36 @5,7 0x0000
sprite @13,7 sprite:jigpiece (u32)0
sprite @11,6 sprite:treasure (u8:itemid)crystal (u8:quantity)0 (u16:fld)0
