2121212121212121212121212121212121212121
2121212121212121212121212121212121212121
2121212121212121212121212121212121212121
2121212121212113313131313131313131313131
2121212121212122050303020405020401040200
2121212121212122040205040106000207020205
2121212121212122000310111111111111111111
2121212121212122020620212121212121212121
2121212121212122010420212121212121212121
2121212121212122070320212121212121212121
2121212121212122060520212121212121212121
2121212121212122020720212121212121212121

image image:caves
position 0 8 2 *
sprite @8,4 sprite:jigpiece (u32)0
rspriteres rsprite:usouthwest
