2121212121212122000220212121212121212121
2121212121212122000720212121212121212121
2121212121212122010020212121212121212121
2121212121212122020220212121212121212121
2121212121212122010330313131313131313131
2121212121212122070600010607000607020501
2121212121212122050202040105020203000203
2121212121212123111111111111111111111111
2121212121212121212121212121212121212121
2121212121212121212121212121212121212121
2121212121212121212121212121212121212121
2121212121212121212121212121212121212121

image image:caves
position 0 9 2 *
sprite @12,5 sprite:jigpiece (u32)0
