2121212121212122000630313131313131313114
2121212121212122000602040202030404020720
2121212121212122010204030006050703040720
2121212121212122020605070503010102060620
2121212121212122010006020405060007040330
2121212121212122070607010602070000060200
2121212121212122050202040105020203000203
2121212121212123111111111111111111111111
2121212121212121212121212121212121212121
2121212121212121212121212121212121212121
2121212121212121212121212121212121212121
2121212121212121212121212121212121212121

image image:caves
position 0 9 2 *
sprite @12,5 sprite:jigpiece (u32)0
sprite @14,2 sprite:treasure (u8:itemid)shovel (u8:quantity)0 (u16:fld)0
rspriteres rsprite:usouthwest
