1331313131313131320400063031313131313114
2206020400020100070200010101020500030120
2206000000000000000000000000000000000420
2205000000000000000000000000000000000720
2203000000000000000000000000000000000320
3200000000000000000000000000000000000130
0000000000000000000000000000000000000300
1205000000000000000000000000000000000007
2205000000000000000000000000000000000610
2207000000000000000000000000000000000420
2201020005040707060007020701070104060720
2311111111111112010002101111111111111124

image image:caves
position 2 1 2 *
