2121212121212121212121212113313131313131
3131313114212121133131313132070500030304
0105030430313131320203070006050606070407
0000040205030201030007040540414141414141
4142040505070600060504404154515151515151
5153414141414141414141545151515151515151
5151515151515151515151515151515151515151
5151515151515151515151515151515151515151
5151515151515151515151515151515151515151
5151515151515151515151515151515151515151
5151515151515151515151515151515151515151
5151515151515151515151515151515151515151

image image:caves
position 2 1 2 *
sprite @5,4 sprite:jigpiece (u32)0
