4141414141414141414141414141414141414141
0106060403000104010401030006010504000105
0606040004040302030300060403010503020106
0305030000030306000502050003000400000502
0601050604000603050000030000060000000502
0305040302450006030606000003000002050000
0504040306014444060402040601050406060603
0602020106020301054343434344430304060004
0406060506000004040100040303040101000300
0101040100010404010202020104060400050302
0302050203020400030603030001010503030102
0302000204010300010301000003000104020204

image image:meadow
position 4 0 1 *
sprite @11,4 sprite:jigpiece (u32)0
