4343434343434343434343434343434343434343
0000000000000000000000000000000000000000
0000000000000000000000000000000000000000
0000000000000000000000000000000000000000
0000000000000000000000000000000000000000
0000000000430000000000000000000000000000
0000000000004343000000000000000000000000
0000000000000000004343434343430000000000
0000000000000000000000000000000000000000
0000000000000000000000000000000000000000
0000000000000000000000000000000000000000
0000000000000000000000000000000000000000

image image:meadow
position 4 0 1 *
