0105050400020202020605060304010005040006
0404030401040004050305020600060401060306
0502060302040101030103020305040601000005
0100030400000102010500020001060001000606
0605050606030310050002010606000205020201
0401000104060012020002000501020006010200
0603060106010611111301000205060605050606
0406030200040604050601020201000401000402
0204000502000603050404060000000301030605
0106040602060406050405020200040200000306
0604020602010604000505000401000006040301
0006040200050600000203010504050104010102

image image:meadow
position -2 2 1 *
