2121212121212121220707070020212121212121
2121212121212121220100050320212121212121
2121212121211331320501070030142121212121
2121212121133202040703070602303131313131
2121212121220600010000050201010405030705
2121212121220105011012040207010003070102
2121212121220703053032040700010604020606
2121212121220007010507060500101111111111
2121212121231204000702050010242121212121
2121212121212311111111111124212121212121
2121212121212121212121212121212121212121
2121212121212121212121212121212121212121

image image:caves
position 4 1 2 *
sprite @11,5 sprite:jigpiece (u32)0
race @12,5 6 4
track @12,5 6 16
track @9,1 6 17
rspriteres rsprite:unorth
