2121212121212121220406202121212121212121
2121212121212121220403202121212121212121
2121212121212113320203301421212121212121
3131313131313132060106063031313131313131
0401040300020302070204000205040603070101
0206010201010303021012000303000200030200
0704060504040102013032070406000300070501
1111120306020700030603070300010003101111
2121231112020006050007030007061011242121
2121212123120203010607050603102421212121
2121212121231111111111111111242121212121
2121212121212121212121212121212121212121

image image:caves
position 5 1 2 *
sprite @7,5 sprite:jigpiece (u32)0
race @10,7 6 3
track @12,6 6 13
track @9,8 6 14
track @6,5 6 15
rspriteres rsprite:unorth
