2121212121212121220402202121212121212121
2121212121212121220103202121212121212121
2121212121212113320602301421212121212121
3131313131313132030707023031313131313131
0605020705020506020203000100020100030407
0607060306050102020100020001020706010203
0006020502000107000000050105030305070407
1111111111111205060204010610111111111111
2121212121212312070105041024212121212121
2121212121212123120301102421212121212121
2121212121212121231111242121212121212121
2121212121212121212121212121212121212121

image image:caves
position 6 1 2 *
sprite @11,6 sprite:jigpiece (u32)0
track @12,5 6 10
track @10,5 6 11
track @7,5 6 12
rspriteres rsprite:unorth
