1331313131320700000000303131313131313114
2207070004040200000006040200000707010020
2207000000000000000000000000000000000120
2207000000000000000000000000000000000620
2206000000000000000000000000000000000530
3205000000000000000000000000000000000104
0506000000000000000000000000000000000000
0000000000000000000000000000000000000000
0000000000000000000000000000000000000106
0205000000000000000000000000000000000510
1201020405070102000000030107050105020620
2311111111111204000000021011111111111124

image image:caves
position 6 1 2 *
sprite @11,6 sprite:jigpiece (u32)0
