2121212121212200002021212121212121212121
2121212121212201002021212121212121212121
2121212121212206062021212121212121212121
2121212121212205072021212121212121212121
3131313131313201063031313131311421212121
0501050402060205050102000401002021212121
0006000300040302050503060405042021212121
1111111111111202041011111201032021212121
2121212121212202073031313200012021212121
2121212121212206010007010206052021212121
2121212121212201010007040204012021212121
2121212121212311111111111111112421212121

image image:caves
position 7 1 2 *
sprite @9,5 sprite:jigpiece (u32)0
