1331313131313131313203053031313131313114
2205050007050605020407020302040607070720
2203050404101112050502030700000000000220
3200051011242123111111120300000000000620
0105052021212121212121231204020000000430
0001102421212121212121212312010200000504
0300202113313131313114212123120302000000
0610242122080000050730142121231201070605
1124212123111201010405202121212311111111
2121212121212312010004202121212121212121
2121212121212122050002202121212121212121
2121212121212122040005202121212121212121

image image:caves
position 8 1 2 *
door @5,7 map:76 @5,8 (u16:activity)tundra_secret_entrance
sprite @14,4 sprite:jigpiece (u32)0
