1331313131313131313202000002303131313114
2206070404060207010600000004000506000720
2205000000000000000000000000000000000620
2200000000000000000000000000000000000420
3203000000000000000000000000000000000120
0604000000000000000000000000000000000720
0000000000000000000000000000000000000720
0703000000000000000000000000000000000120
1204000000000000000000000000000000000420
2207000000000000000000000000000000000420
2200070104010100000706000102060100060720
2311111111120700000310111111111111111124

image image:caves
position 9 1 2 *
