2121212121220300000320212121212121212121
2121212121220600000020212121212121212121
2121212121220000050020212121212121212121
2121212121231111111124212121212121212121
3131313131313131142121212121212121212121
0301010402070606301421212121212121212121
0000000000000007023031142121212121212121
0605030205000000040207303114212121212121
1111111201000006000007040420212121212121
2121212311111207020000000520212121212121
2121212121212312030000000320212121212121
2121212121212122030000000720212121212121

image image:caves
position 9 2 2 *
sprite @10,7 sprite:jigpiece (u32)0
