2121212121212122050001202121212121212121
2121212121212122000400301421212121212121
2121212121212122000205053031142121212121
2121212121212123120502010005303131142121
2121212121212121220200010407060706303131
2121212121212121231202010206040204000407
1331313131313114212312050005070502030402
3200030703010330142123111204010607000405
0505000601020402301421212312030110111111
0507101112010304012021212123111124212121
1111242123120600012021212121212121212121
2121212121231201072021212121212121212121

image image:caves
position 8 2 2 *
sprite @13,3 sprite:jigpiece (u32)0
