1331313131313132010006303131313131313114
2205020407060601010005020402050307020720
2203000000000000000000000000000000000320
2203000000000000000000000000000000000420
3200000000000000000000000000000000000630
0302000000000000000000000000000000000201
0000000000000000000000000000000000000000
0002000000000000000000000000000000000403
1207000000000000000000000000000000000710
2203000000000000000000000000000000000220
2200030205010404000000030305070702070520
2311111111111112030000061011111111111124

image image:caves
position 8 2 2 *
