2121212121212122000007202121212121212121
2121212121212122060005301421212121212121
2121212121212122050105063031142121212121
2121212121212123120500010300303131142121
2121212121212121220502000004040407303131
2121212121212121231205020000000005010400
1331313131313114212312000106000000000000
3202050501020030142123111201060101010607
0105070106030606301421212312010710111111
0203101112060507012021212123111124212121
1111242123120005012021212121212121212121
2121212121231203062021212121212121212121

image image:caves
position 8 2 2 *
sprite @13,6 sprite:jigpiece (u32)0
