1331313131313132060005303131313131313114
2205020303060700030004000505050702000620
2205000000000000000000000000000000000020
2202000000000000000000000000000000000520
3205000000000000000000000000000000000030
0003000000000000000000000000000000000006
0000000000000000000000000000000000000000
0001000000000000000000000000000000000400
1203000000000000000000000000000000000410
2204000000000000000000000000000000000520
2200020505010005040300000005050001070320
2311111111111111120100000007101111111124

image image:caves
position 7 2 2 *
