4343000000000000000000000000000000000043
4300000000000000000000000000000000000043
0000000000000000000000000000000000000043
0000000000000043000000000000000000000043
0000000000000000000000000000000000000043
0000000000000000000000000000000000000043
0000000000000000000000000000000000000043
0000000000000000000000000000000000000043
0000000000000000000000000000000000000043
0000000000000000000000000000000000000043
0000000000000000000000000000000000000043
0000000000000000000000000000000000000043

image image:meadow
position 7 4 1 *
