2121212121212121212121212121212121212121
2121212121212121212121212121212121212121
2121212121212121212121212121212121212121
2121212121212121212121212121212121212121
2121212121212121212121212121212121212121
2121212121212121212121212121212121212121
3131311413313131311413313131311413313131
0104063032010607003032010106073032060402
0105060202010106040205000705000502050502
1012020103071012000700061012010006071012
2423111111112423111111112423111111112423
2121212121212121212121212121212121212121

image image:caves
position 6 2 2 *
sprite @8,7 sprite:jigpiece (u32)0
rspriteres rsprite:uhome
