2121212121212121212121212121212121212121
1331313131311421212121212121212121212121
3203010006023014212121212121212121212121
0406010106020520212121212121212121212121
0404101112050320212121212121212121212121
1111242122030420212121212121212121212121
2121212122060420212121211331313131141331
2121211332070120212121133204050604303201
2121133207000020212121220702040502070306
2121220205011024212121220004000601030007
2121220407052021212121220602020110111111
2121220100102421212121231202061024212121

image image:caves
position 5 2 2 *
sprite @12,8 sprite:jigpiece (u32)0
rspriteres rsprite:uhome
