1331313131313202000004303131313131313114
2207000605070007000004020603050004030620
2206343434343434343434343434343434340220
3205340000000000000000000000000000000020
0407340000000000000000000000000000000530
0000340000000000000000000000000000000400
0205340000000000000000000000000000000000
1206340000000000000000000000000000000000
2206340000000000000000000000000000000305
2204000000000000000000000000000000000310
2201020504010002010003050504000505040620
2311111111111112050002101111111111111124

image image:caves
position 4 2 2 *
sprite @11,6 sprite:jigpiece (u32)0
