5151515151515151515151520501202121212121
5151515151515151515151520101301421212121
5151515151515151515143620600002021212121
5151515151515151514362030702012021212121
5151515151515151515207040403053014212121
5151515151515151515203000402000720212121
5151515151515151515201020405060420212121
5151515151515151515342070500030530142121
5151515151515151515152000500000100202121
5151515151515151515153420607000007202121
5151515151515151515151534207040501202121
5151515151515151515151515341420104202121

image image:caves
position 3 2 2 *
sprite @15,5 sprite:jigpiece (u32)0
