1331313131313132030006303131313131313114
2201050301060307040001060100020700040020
2201000000000000000000000004070107050120
3206000000000000000000070705000104040320
0704000000000000020402020502060405010530
0000000000000002060205040502030000000400
0000000000050204010606000503000000000000
0607000103060000070107070000000000000100
1202000002000405050000000000000000000310
2205010101010201020000000000000000000520
2203070505060100000000000405050504050520
2311111111111112070000000210111111111124

image image:caves
position 2 2 2 *
