5151515151515151515151515151515151515151
5151515151515151515151515151515151515151
5151515151436161616161616161614451515151
5151515143620402060605010005016044515151
5151514362050106060507020307060060445151
5151515202070402020400020504040404505151
5151515202050203030305010604070004505151
5151515201010606010204010200040640545151
5151515342060404000101030106030250515151
5151515153414141420602070705404154515151
5151515151515151534141414141545151515151
5151515151515151515151515151515151515151

image image:caves
position 2 2 2 *
sprite @8,5 sprite:jigpiece (u32)0
