5151515151515151515151515151515151515151
5151515151515151515151515151515151515151
5151515151515151515151515151515151515151
5151436161616144515151515151515151515151
6161620506020460614451515151515151515151
0202000300000400056061616161445151515151
0000000006030304030407070104606161616161
0007050302050103040401000006000400010205
0205101207040304010502050303020205000501
1111242312040500060510111111111205060006
2121212123120700050620212121212311111111
2121212121220300000020212121212121212121

image image:caves
position 2 3 2 *
sprite @7,5 sprite:jigpiece (u32)0
