5151515151515151515151515151520105303114
5151515151515151515151515151520601030120
5151515151515151515151515151534206060220
5151515151515151515151515151515342010720
5151515151515151515151515151514362000720
5151515151515151515151515151515206040020
6161616161445151515151515151436200071024
0206030304606161616161616161620304042021
0001000502010105060101020706040107002021
0106040401010402050302060602040506102421
1111111111111206020203040100021011242121
2121212121212311111111111111112421212121

image image:caves
position 3 3 2 *
sprite @11,10 sprite:jigpiece (u32)0
race @4,1 2 3
track @4,1 2 3
