0105010106020601020404020406030004010205
0206030105060106040400030205060204030300
0002050004020100000601010502040304040000
0002040001010301060304060103040203020503
0505030600060405020606060304050006030405
8205010305050405a3a306030604020600040180
9200060204050600a30006000400000004040390
9204010204020104030504010104040404050090
9202060505020600040106000406000003020690
9201040300060200010603060501020100050090
9201030304000401010206050304050105010190
9381818181818181818181818181818181818194

image image:meadow
position 2 -2 1 *
