3131313131313131313114152525252521252125
0607040403070201070030142525211521212525
0804030000070000070608303131313114152515
7171720802707171720305707171717220252515
8181820504808181820502808181818220152525
9191920203858687880708909191919220212115
a1a1a20601a093a1450204a093a3a4a220152115
0302010003040605010606070701080430142521
0805000804030001060606000504060201202515
0102080306707171720108707171720205202125
0208040802808181820308808181820101202525
0306020706909191920607a5a6a7a80000201521

image image:fractia
position 7 3 1 *
endorsement @8,6 (u16:fld)endorse_hospital
door @6,6 map:169 @10,9 0x0000
door @12,6 map:121 @9,8 0x0000
