0105000606050000060506010502000103010590
0103001304060604050106061101030600040390
0602040400000603030106020503030004050390
0406010006010102060504010506000400808194
0601020502000601060501010506010580949191
0404020002021306060100050606018094919191
0405060106060406040604050680819491919191
0603040404040602030004048094919191919191
0603010300000001050401029091919191919191
0201000502050006041105009091919191919191
8181818200050004030301809491919191919191
9191919381820300000380949191919191919191

image image:meadow
position 4 2 1 *
song song:nearer_the_sky
sprite @9,4 sprite:jigpiece (u32)0
