2121220406301421212121133206022021212121
2121220300012021212121220701072021212121
2121231200072021212121220107102421212121
2121212204002021212121220500301421212121
2113313202002021212121220706032021212121
3132050104102421212121231205062021212121
0203040610242121212121133202062021212121
0700020630142121212121220305042021212121
1112010603301421212121220207102421212121
2123120106062021212121220503301421212121
2121231201022021212121220603022021212121
2121212202032021212121231201012021212121

image image:caves
position 5 3 2 *
sprite @12,7 sprite:jigpiece (u32)0
