1331313131313131313131313131313131313131
2202070105010407060505030101020004040503
2203101112051011120010111200101112061011
2202202122062021220520212207202122032021
2201303132063031320230313207303132043031
2205060500040705070107070404020502020401
2207101112001011120710111205101112021011
2206202122002021220620212202202122052021
2206303132063031320130313202303132073031
2204060005010007040304050102040102040701
2200101112021011120110111203101112011011
2203202122002021220420212207202122022021

image image:caves
position 6 3 2 *
sprite @9,5 sprite:jigpiece (u32)0
