3131313131313131313131313131313131313114
0107050605010201020406060703020503040120
0100000103020205040701000401060004010420
1206001012030210120605101203041012040620
3200053032060530320604303202003032040020
0306020302070701070402030504050207000020
0704050004000601070705040706060704030120
1200031012070010120203030406031012020120
3203043032040130320004030404063032070720
0300030002040606060707020604000406010120
0405030102000702030400070503020700030520
1202061012000110120106101201071012010420

image image:caves
position 7 3 2 *
sprite @9,5 sprite:jigpiece (u32)0
sprite @11,7 sprite:treasure (u8:itemid)stopwatch (u8:quantity)0 (u16:fld)0
rspriteres rsprite:ufractia
surveyor (u16:fld16)surveyor_b
