2121212121133207002021212121212121212121
2121212121220200042021212121212121212121
2121212121220404102421212121212121212121
2121212121220201301421212121212121212121
2121212121220606052021212121212121212121
2121212121231207062021212121212121212121
2121212121133201032021212121212121212121
2121212121220504052021212121212121212121
2121212121220007102421212121212121212121
2121212121220702301421212121212121212121
2121212121220304012021212121212121212121
2121212121231205072021212121212121212121

image image:caves
position 8 3 2 *
sprite @8,5 sprite:jigpiece (u32)0
rspriteres rsprite:uhome
