1331313131313132060000053031313131313114
2204030406060603030000010204070102010520
2207000000000000000000000000000034340720
3200000000000000000000000000003434000620
0102000000000000000000000000003400000730
0000000000000000000000000000340000000607
0000000000000000000000003434340000000000
0506000000000000000034343400000000000304
1200000034343434343434000000000000000410
2202343434000000000000000000000000000420
2204050305020000000703020506060705040320
2311111111111205000510111111111111111124

image image:caves
position 8 3 2 *
