1331313131313132070000000630313131313114
2202050107030407010000000706010702040020
2206343434343434343434343434343434340420
2205000000000000000000000000000000340520
3203000000000000000000000000000000340120
0603000000000000000000000000000000340120
0000000000000000000000000000000000340420
0500000000000000000000000000000000340220
1202000000000000000000000000000000340120
2201000000000000000000000000000000340120
2203070604000007010706060706030601070020
2311111207000000101111111111111111111124

image image:caves
position 9 3 2 *
