2121212121212122040206010420212121212121
2121212121212122040305030020212121212121
2121212121211332020600010520212121212121
2121212121212206040607050020212121212121
2121212121133204010006070420212121212121
2121212121220002050404000420212121212121
2121212113320307030306071024212121212121
2121212122070406030303102421212121212121
2121211332030605010710242121212121212121
2121212206060003001024212121212121212121
2121212203030202102421212121212121212121
2121212203000100202121212121212121212121

image image:caves
position 9 3 2 *
sprite @12,5 sprite:jigpiece (u32)0
rspriteres rsprite:ueast
surveyor (u16:fld16)surveyor_c
