2121212207050303202121212121212121212121
2121212204020206202121212121212121212121
2121212205020407303131313131142121212121
212121220502040104002e2e2e2e202121212121
2121212312060103047374747475202121212121
2121212123120605008384848485202121212121
2121212121220601009394949495202121212121
2121212121220702000205001011242121212121
2121212121231204060301012021212121212121
2121212121212202000602012021212121212121
2121212121212312060505022021212121212121
2121212121212122020506062021212121212121

image image:caves
position 9 4 2 *
sprite @13,6 sprite:jigpiece (u32)0
sprite @10,3 sprite:ticker (u16:fld)zoo15_0 (u16)0
zookeeper @9,4,5,3
sprite @13,4 sprite:zookeeper (u16:fld)zoo15_0 (u16)0
surveyor (u16:fld16)surveyor_c
