2121212207050303202121212121212121212121
2121212204020206202121212121212121212121
2121212205020407301421212121212121212121
2121212203070401063014212121212121212121
2121212312020303050030142121212121212121
2121212123120305020101202121212121212121
2121212121220601070305301421212121212121
2121212121220702040307012021212121212121
2121212121231204060301012021212121212121
2121212121212202000602012021212121212121
2121212121212312060505022021212121212121
2121212121212122020506062021212121212121

image image:caves
position 9 4 2 *
sprite @9,6 sprite:jigpiece (u32)0
