1331313131313202000330313131313131313114
2202020707010605000503000002020507050320
2200340000000000000000000000000000000620
3206340000000000000000000000000000000520
0605340000000000000000000000000000000730
0000340000000000000000000000000000000702
0407340000000000000000000000000000000000
1203340000000000000000000000000000000205
2200340000000000000000000000000000000010
2206340000000000000000000000000000000020
2203070000020302010000010405060202030320
2311111111111112030000031011111111111124

image image:caves
position 8 4 2 *
sprite @8,5 sprite:jigpiece (u32)0
