2121212121133206002021212121212121212121
2121212121220403072021212121212121212121
2121212121220605102421212121212121212121
2121212121220606301421212121212121212121
2121212121220401032021212121212121212121
2121212121231206062021212121212121212121
2121212121133205042021212121212121212121
2121212121220603042021212121212121212121
2121212121220304102421212121212121212121
2121212121220102301421212121212121212121
2121212121220506012021212121212121212121
2121212121231200042021212121212121212121

image image:caves
position 8 4 2 *
sprite @8,5 sprite:jigpiece (u32)0
rspriteres rsprite:uhome
