3203303132043031320030313206303132022021
0503040505050403010701070304050005052021
1204101112071011120710111207101112072021
2203202122012021220720212200202122042021
3206303132063031320730313205303132042021
0000070504060603020007070004050502052021
1200101112061011120710111207101112012021
2205202122022021220420212203202122072021
3202303132043031320630313203303132052021
0400030203040103060601050106010507062021
1111111111111111111111111111111111112421
2121212121212121212121212121212121212121

image image:caves
position 7 4 2 *
sprite @9,5 sprite:jigpiece (u32)0
