1331313132030000013031313131313131313114
2206060501030000010401050700070704050020
2200000000000000000000000000000034000120
2201000000000000000000000000000034000030
3201000000000000000000000000000034000100
0404000000000000000000000000000034000000
0000000000000000000000000000000034020607
0000000000000000000000000000000034011011
0303000000000000000000000000000034072021
1202343434343434343434343434343434022021
2203000005000000000704010303070004062021
2311111202000000000010111111111111112421

image image:caves
position 7 4 2 *
