3203023032030230320303303200003032070120
0406050004070706010302000207030405060520
0601040005030102000101060407030507070520
1203041012010310120400101205031012040620
3202013032000530320503303203023032000720
0002000102070303050004000206010002070520
0201040104070006020004070203040300010320
1206021012030010120300101204021012060320
3207053032040630320204303202043032040620
0602010306010303040701050507060607010020
0704050003060500010206050102070102050020
1111111111111111111111111111111111111124

image image:caves
position 7 4 2 *
sprite @9,5 sprite:jigpiece (u32)0
rspriteres rsprite:ufractia
surveyor (u16:fld16)surveyor_b
