2205303132073031320730313200303132073031
2201010506060600010705070000000502050201
2200101112011011120110111203101112061011
2204202122032021220220212201202122002021
2205303132003031320030313205303132063031
2205020201060400020207000202070505060003
2200030402010103040210111207101112031011
2207030505080507060720212206202122062021
2205010604070300000130313204303132013031
2202050504060600050407060305060103070501
2311111111111111111111111111111111111111
2121212121212121212121212121212121212121

image image:caves
position 6 4 2 *
sprite @9,5 sprite:jigpiece (u32)0
door @5,7 map:222 @5,7 0x0000
