2202003032000130320705303207053032010130
2205050601070500040602000201020000000001
2205010505070702060004040603050502020406
2204051012000310120003101202001012030510
2202043032010730320402303200043032060730
2203020401040306020302040006030705050300
2204070702010103040700020505050202030004
2311120705080507060103101203021012020410
2121220704070300000607303203063032000330
2121220605030600040501050506000202000707
2121231111111112040004000304050601030006
2121212121212123111111111111111111111111

image image:caves
position 6 4 2 *
sprite @9,5 sprite:jigpiece (u32)0
door @5,7 map:222 @5,7 0x0000
rspriteres rsprite:ufractia
surveyor (u16:fld16)surveyor_b
