2205303132073031320730313200303132073031
2201010506060600010705070000000502050201
2200101112011011120110111203101112061011
2204202122032021220220212201202122002021
2205303132003031320030313205303132063031
2201020300040505070407000202070505060003
2204101112001011120710111207101112031011
2206202122002021220020212206202122062021
2202303132053031320530313204303132013031
2203050607000403060407060305060103070501
2311111111111100111111111111111111111111
2121212121212100212121212121212121212121

image image:caves
position 6 4 2 *
sprite @9,5 sprite:jigpiece (u32)0
