2121133201042021212121133202022021212121
2121220707032021212121220203032021212121
2121220707003014212121220206102421212121
2121220204040320212121220202301421212121
2121220101030420212121220501022021212121
2121231111120530142121231202072021212121
2121212121220707202121133206042021212121
2121212121231205202121220206042021212121
2121211331313205202121220005102421212121
2121212207000506202121220401301421212121
2121212204101111242121220201072021212121
2121212200202121212121231207002021212121

image image:caves
position 5 4 2 *
sprite @14,4 sprite:jigpiece (u32)0
rspriteres rsprite:uhome
