1331313132050000000230313131313131313114
2204040102050000000401030707020702020320
2202000000000000000000000000000000340220
3205000000000000000000000000000000340030
0606000000000000000000000000000000340504
0000000000000000000000000000000000340000
0000000000000000000000000000000000340000
0000000000000000000000000000000000340301
0305000000000000000000000000000000340410
1203003434343434343434343434343434340220
2201030107040703010007020204060206030220
2311111111111112070002101111111111111124

image image:caves
position 5 4 2 *
