1331313203000003303131313131313131313114
2206050003000003050000070704000704030520
2207000000000000000000000000000000000620
2203000000000000340000000000000000000030
3206000000000000340000000000000000000202
0007000000000000343400000000000000000000
0000000000000000003434000000000000000000
0105000000000000000034340000000000000000
1206000000000000000000003434340000000205
2202000000000000000000000000343434340710
2203050407070500010203000602020201050420
2311111111111111111204000010111111111124

image image:caves
position 4 4 2 *
sprite @6,5 sprite:jigpiece (u32)0
