2121212121212121212121212121212121212121
2121212121212121212121212121212121212121
2121212121212121212121212121212113313114
2121212121212121212121133131313132020120
2121212121212121133131320107010405050230
2121212121133131320407040402060434050403
2121212113320201030105000700060606050100
2121212122060034040003010204050403050701
2121212122010106060206030510111111111111
2121212122030502070305101124212121212121
2121212122020107101111242121212121212121
2121212122040107202121212121212121212121

image image:caves
position 3 4 2 *
sprite @10,6 sprite:jigpiece (u32)0
