2121212121220400000720212121212121212121
2121212121220400000720212121212121212121
2121212113320400020230142121212121212121
2121211332070204010605301421212121212121
2121212203020205060603012021212121212121
2121212206040705060104022021212121212121
2121212202010501050606032021212121212121
2121212204020107000306102421212121212121
2121212312030203060107202121212121212121
2121212122070001030604202121212121212121
2121212123111111120306202121212121212121
2121212121212121220407202121212121212121

image image:caves
position 2 4 2 *
sprite @8,5 sprite:jigpiece (u32)0
track @6,4 2 5
track @10,10 2 6
track @7,1 2 9
rspriteres rsprite:ubotire
