2121212121212121212121212121212121212121
2121212121212121212121212121212121212121
2121212121212121212121212121212121212121
2121212121212113313131142121212121212121
3131313131313132050503303131313131313131
0107060400060105020100040404020606030605
0003060606000505050703010702030501010100
1111111111111202030410111111111111111111
21212121212123120e0220212121212121212121
2121212121133132021024212121212121212121
2121212113320004072021212121212121212121
2121212122050701032021212121212121212121

image image:caves
position 1 5 2 *
sprite @9,4 sprite:jigpiece (u32)0
switchable @8,8 (u16:fld)jungle_underdoor
rspriteres rsprite:uwest
