2121212121212121212121212121212121212121
2121212121212121212121212121212121212121
2121212121212121212121212121212121212121
2121212121212113313131142121212121212121
3131313131313132050503303131313131313131
0107060400060105020100040404020606030605
0003060606000505050703010702030501010100
1111111111111204040010111111111111111111
2121212121212203010620212121212121212121
2121212121133203071024212121212121212121
2121212113320600022021212121212121212121
2121212122050701032021212121212121212121

image image:caves
position 1 5 2 *
sprite @9,4 sprite:jigpiece (u32)0
