1331313131313131320703303131313131313114
2205060505010700000102050603010207030020
2205060407010401050005010000040304030220
2201040e0e070100000604060707000206070220
3206060e000e0507070700010301000701030420
0103020e0e010607070704020201040305060620
0202020e030e0105050200080207040006060230
1206020e0e030205070007010003010100070507
2206070505040202050505000504010406050500
2202060105010600050104000301010604000210
2207060206010105040506000503000501020720
2311111111111112010410111111111111111124

image image:caves
position 2 5 2 *
sprite @9,5 sprite:jigpiece (u32)0
door @11,6 map:116 @6,4 0x0000
race @15,9 2 5
track @14,8 2 7
race @9,1 2 6
track @10,1 2 8
rspriteres rsprite:ubotire
