1331313131313131320000000630313131313114
2205000105070106030300000204040507040120
3200000000000000000000000000000000000420
0206003400000000000000000000000000000620
0000003400000000000000000000000000000430
0000003400000000000000000000000000000704
0000003400000000000000000000000000000000
1202003400000000000000000000000000000000
2202003434343434343434343434343434000106
2203000000000000000000000000000000000010
2201020606060104020004060504020704070420
2311111111111112000007101111111111111124

image image:caves
position 2 5 2 *
