2121212122010204202121212121212121212121
2121212122050106301421212121212121212121
2121212123120204033014212121212121212121
2121212113320304010430142121212121212121
2121211332030300050206202121212121212121
2113313205000405060204202121212121212121
3132020100030001020407202121212121212121
0402030601050102060710242121212121212121
0604030404340210120420212121212121212121
1111120202040320231124212121212121212121
2121231111111124212121212121212121212121
2121212121212121212121212121212121212121

image image:caves
position 3 5 2 *
sprite @9,5 sprite:jigpiece (u32)0
