1331313207000003303131313131313131313114
2204030106000006060107020501040407030620
2201000000000000000000000000000000000020
2200000000000000000000000000000034000030
3201000000000000000000000000000034000100
0100000000000000000000000000000034000000
0000000000000000000000000000000034000000
0000000000000000000000000000000034000206
0406003434343434343434343434343434000110
1203000000000000000000000000000000000020
2204050302050707020500000704060102060420
2311111111111111120100000110111111111124

image image:caves
position 3 5 2 *
sprite @9,5 sprite:jigpiece (u32)0
