2121212121212121212121212121212121212121
2121212121212121211331313114212121212121
2121212121133131313204030330142121212121
2121212113320107010705340401202121212121
2121211332020003010203060603303131313131
2121133207030103070403000000040603000705
2121220503330207040007000301010305050606
2121231204030402101111120400050401101111
2121212201070103303114220206021011242121
2121212312040401020820220704102421212121
2121212123111205030320220310242121212121
2121212121212311111124231124212121212121

image image:caves
position 4 5 2 *
sprite @9,6 sprite:jigpiece (u32)0
rspriteres rsprite:uhome
door @9,9 map:47 @9,9 (u16:activity)forest_secret_entrance
