1331313131313131313206000730313131313114
2206070300020404050703000506070106030020
2207343434343434343434343434343434340120
3206340000000000000000000000000000000630
0603340000000000000000000000000000000204
0000340000000000000000000000000000000000
0000340000000000000000000000000000000000
0305340000000000000000000000000000000307
1205340000000000000000000000000000000210
2202340000000000000000000000000000000720
2203040006070300000006070101040407030020
2311111111120500000003101111111111111124

image image:caves
position 4 5 2 *
sprite @9,6 sprite:jigpiece (u32)0
