2121212205202121212121133207062021212121
2121212201202121212121220404023014212121
2121133200303114212121220103030130313131
2113320405020730142121220500000205040202
3132010102070705301421220702040607050304
0202020702050404042021231203050005040010
0603020406060300012021212311111111111124
1112000107030605032021212121212121212121
2123120600060303102421212121212121212121
2121231203040710242121212121212121212121
2121212312020020212121212121212121212121
2121212122060720212121212121212121212121

image image:caves
position 5 5 2 *
sprite @8,6 sprite:jigpiece (u32)0
