1331313131313131320300000006303131313114
2202070007020100070300000004060102060220
3205343434343434343434343434343434340220
0006000000000000000000000000000000000720
0000000000000000000000000000000000000020
0000000000000000000000000000000000000430
0701000000000000000000000000000000000005
1203000000000000000000000000000000000507
2200000000000000000000000000000000000010
2200000000000000000000000000000000000420
2207070707070002000600050704040303010320
2311111111120607101111111111111111111124

image image:caves
position 6 5 2 *
sprite @10,6 sprite:jigpiece (u32)0
