1331313131313131313131311421212121212121
2203030307060506010200072021212121212121
3203070200040503030705032021212121212121
0403070004060403040005003031313114133131
0700020500040501060205070302050330320103
1204050202060502040204000202010707040504
2205070600040306000704031011120402020510
2205070705050306020101022021231111111124
2207020406010507000506072021212121212121
2201060607020204060701012021212121212121
2203030606020203060300042021212121212121
2311111111120705101111112421212121212121

image image:caves
position 6 5 2 *
sprite @10,6 sprite:jigpiece (u32)0
rspriteres rsprite:uhome
