4203000601020502040603040001050600010430
0103010102000204000400010204000500050040
0002000206020605010204050000020201060500
0602060405060400020401000401020601050406
0202060200040400040403010000030202060501
0200050504040500040204050400010000020400
0602060305060301020405030205030503050405
0200020003020505040303060201060100010503
0400020100202122050500000403010206060605
0305040003303133212121212121212122010406
0004060000303125312531252525352533212121
0102030004303531353531253131352525253125

image image:tundra
position 7 1 1 *
sprite @9,6 sprite:jigpiece (u32)0
