1331313131313132020000053031313131313114
2207020502010103070000030700040200000120
2203340000000000000000000000000000000020
2203340000000000000000000000000000000120
3202340000000000000000000000000000000230
0507340000000000000000000000000000000306
0404340000000000000000000000000000000000
1203340000000000000000000000000000000303
2207340000000000000000000000000000000010
2200340000000000000000000000000000000520
2200060400010004000000070604040405020020
2311111111111205000000071011111111111124

image image:caves
position 8 5 2 *
