2121212121212122070000043014212121212121
2121212121212122020000030720212121212121
2121212121211332020000070620212121212121
2121212121212206040006031024212121212121
2121212121212205000504102421212121212121
2121212121212203000310242121212121212121
2121212121212206000320212121212121212121
2121212121212202060330142121212121212121
2121212121212312060201202121212121212121
2121212121212122040305202121212121212121
2121212121212123120402202121212121212121
2121212121212121220004202121212121212121

image image:caves
position 9 5 2 *
sprite @12,2 sprite:jigpiece (u32)0
