1331313131313132000000043031313131313114
2202070700050103020000030001040306010520
2206000000000000000000000000000000340720
2206000000000000000000000000000000340720
3202000000000000000000000000000000340220
0700000000000000000000000000000000340620
0000000000000000000000000000000000340220
0703000000000000000000000000000000340520
1206000000000000000000000000000000340020
2207000000000000000000000000000000340220
2200070503030204010000010704060401070320
2311111111111111120502101111111111111124

image image:caves
position 9 5 2 *
