2121212121212122070000043014212121212121
2121211331142122020000030720212121212121
2113313203201332020000070620212121212121
1332070304202206040006031024212121212121
3203020002202205000504102421212121212121
0700000003202203000310242121212121212121
0000000101202206000320212121212121212121
0407050210242202060330142121212121212121
1111111124212312060201202121212121212121
2121212121212122040305202121212121212121
2121212121212123120402202121212121212121
2121212121212121220004202121212121212121

image image:caves
position 9 5 2 *
sprite @12,2 sprite:jigpiece (u32)0
