2121211332020206022021212121212121212121
2121212203000202003031311421212121212121
2121133204050705020104022021212121212121
2113320303020407101112042021212121212121
2122040600000210242122042021212121212121
3132030000060620212122063031313131313131
0701050000031024212122000106010004010606
0307040104002021212123111111111111111111
1111111111112421212121212121212121212121
2121212121212121212121212121212121212121
2121212121212121212121212121212121212121
2121212121212121212121212121212121212121

image image:caves
position 1 6 2 *
sprite @2,4 sprite:jigpiece (u32)0
sprite @9,2 sprite:pound (u32)0
rspriteres rsprite:uwest
