1331313131313131320300013031313131313114
2207020301010305010000030207050300030320
2204343434343434343434343434343434340620
2202000000000000000000000000000000000020
2201000000000000000000000000000000000530
3203000000000000000000000000000000000201
0307000000000000000000000000000000000000
0206000000000000000000000000000000000002
1201000000000000000000000000000000000610
2204000000000000000000000000000000000420
2204030606070600070605020405010505040520
2311111111120500041011111111111111111124

image image:caves
position 1 6 2 *
sprite @10,6 sprite:jigpiece (u32)0
