2121211332020206022021212121212121212121
2121212203000202012021212121212121212121
2121133204050706102421212121212121212121
2113320303020404202121212121212121212121
2122040600000210242121212121212121212121
3132030000060620212121212121212121212121
0701050000031024212121212121212121212121
0307040104002021212121212121212121212121
1111111111112421212121212121212121212121
2121212121212121212121212121212121212121
2121212121212121212121212121212121212121
2121212121212121212121212121212121212121

image image:caves
position 1 6 2 *
sprite @5,7 sprite:jigpiece (u32)0
