1331313131313132040002303131313131313114
2203020200030602020005060006000605060620
2205343434343434343434343434343434340620
2206000000000000000000000000000000340020
3200000000000000000000000000000000340030
0005000000000000000000000000000000340101
0000000000000000000000000000000000340000
0703000000000000000000000000000000340000
1204000000000000000000000000000000340300
2202000000000000000000000000000000340510
2206000500030405020101040503040403000120
2311111111111111111112040610111111111124

image image:caves
position 2 6 2 *
