2121212121212122070730142121212121212121
2121212121212122010106202121212121212121
2121212121212122000100303114212121212121
2121212121212122020505030430311421212121
2121212121212122040400010101013031313131
2121212121212123120703040301060204050107
2121212121212121231112070607070003010600
2121212121212121212123111200060101050300
2121212121212121212121212312030006060007
2121212121212121212121212123111111111111
2121212121212121212121212121212121212121
2121212121212121212121212121212121212121

image image:caves
position 2 6 2 *
sprite @12,3 sprite:jigpiece (u32)0
