2121212121212121212121212121212121212121
2121212121212121212121212121212121212121
2121212121212121212121133131313114212121
2121212121212121212113320305070630142121
3131311421212121211332040300000202303131
0607063031313131313201070310120204030202
0000070607040302060005011024231112000400
0000000000000701060703102421212123111111
0105010505101111111111242121212121212121
1111111111242121212121212121212121212121
2121212121212121212121212121212121212121
2121212121212121212121212121212121212121

image image:caves
position 3 6 2 *
sprite @10,5 sprite:jigpiece (u32)0
