1331313131313131320100000730313131313114
2205020305000500000400000300020700040020
2202000000000000000000000000000000000430
2200000000000000000000000000000000000402
3206000000000000000000000000000000000000
0105000000000000000000000000000000000000
0000000000000000000000000000000000000000
0000000000000000000000000000000000000005
0607000000000000000000000000000000000410
1201000000000000000000000000000000000520
2204010705040000000300030703060103050320
2311111112070000000510111111111111111124

image image:caves
position 3 6 2 *
