1331313131320200000000303131313131313114
2207010005040400000006030003060403040320
3202340000000000000000000000000000000520
0607340000000000000000000000000000000020
0000340000000000000000000000000000000430
0000340000000000000000000000000000000101
0000340000000000000000000000000000000000
0407340000000000000000000000000000000203
1207340000000000000000000000000000000210
2201340000000000000000000000000000000420
2201020300070000010006000304010603030320
2311111112020000001011111111111111111124

image image:caves
position 4 6 2 *
