2121212122050320212121212121212121212121
2121212122030530142121212121133131142121
2121212122060605303131142113320102301421
2121212123120706040505303132010307023014
2121212121220404060701000406020205030730
2121212113320302030307030601010503040302
2121211332000205040200020507070604030210
2121212201050203040704060603040606041024
2121212204050402050400050007020110112421
2121212312000106010401070702011024212121
2121212123111205030003031011112421212121
2121212121212311111111112421212121212121

image image:caves
position 5 6 2 *
sprite @9,7 sprite:jigpiece (u32)0
rspriteres rsprite:uhome
