1331313131320202303131313131313131313114
2201020003070003060701050403010400070520
2206010305010705070734070003050602050720
2207070303070006003407340101030106040020
3206060606010005340307053407050405070320
0101040507020606340503073400000605010420
1203030103063434343333333334340000030420
2202060202040002000302040603070304050320
2204050304060006020500050003060200000520
2204070308070001060407060402030003070420
2200000002030200030000000405020700010520
2311111111111206051011111111111111111124

image image:caves
position 6 6 2 *
sprite @11,7 sprite:jigpiece (u32)0
door @4,9 map:start @4,9 0x0000
rspriteres rsprite:uhome
