1331313131320202303131313131313131313114
2206060101040302030305060102020403020120
2204000000000000000034000000000000000530
2203000000000000003400340000000000000501
3206000000000000340000003400000000000000
0204000000000000340000003400000000000000
0000000000003434343434343434340000000000
0006000000000000000000000000000000000000
1200000000000000000000000000000000000007
2204000000000000000000000000000000000510
2207010004030000030303030704050205070020
2311111112010000061011111111111111111124

image image:caves
position 6 6 2 *
