2121212121212121212121212121212121212121
2121212121212121212121212121212121212121
2121212121212121212121212121212121212121
2121212121212121212121212121211331313131
2121212121212121133131311413313204010307
2121212121212113320005023032000104060501
2121212121212122030207070102040505101111
2121212121212122010202000503051011242121
2121212121212122050204070202102421212121
2121212121212122070706031011242121212121
2121212121212123120606102421212121212121
2121212121212121220203202121212121212121

image image:caves
position 7 6 2 *
sprite @8,6 sprite:jigpiece (u32)0
