9191919191919191919191919191919191919191
9191919191919191919191919191919191919191
9191919191919191919191919191919191919191
9191919191919191919191919191919191919191
9191919191919191919191919191919191919191
9191919191919191919191919191919191919191
9191919191919191919191919191919191919191
9191919191919191919191919191919191919191
9191919191919191919191919191919191919191
a1a1a1a1a1a1a1a1a1a1a1a1a1a1a1a1a1a1a1a1
0004020600000206010300050103060200010406
0206010602040604050302000302020001000200

image image:meadow
position 2 1 1 *
