9191919191919191911591919191919191919191
9191919191919183a115a1849191919191919191
9191919191919192000203909191919191919191
9191919191919192020106909191919191919191
9191919191919192060600909191919191919191
9191919191919193811581949191919191919191
9191919191919191911591919191919191919191
a1a1a184919191919115919191919191919183a1
020004a0a1a18491911591919191919183a1a205
010006060403a0a1a115a1a1a1a1a1a1a2010204
0601020204020402030205050305010500010200
0301020406000204050006060003050004060000

image image:desert
position 2 3 1 *
sprite @9,3 sprite:jigpiece (u32)0
song song:blood_for_silver
