1331313131313203000000073031313131313114
2207060702010706000000040200060101060120
2207340000000000000000000000000000000020
3205340000000000000000000000000000000130
0001340000000000000000000000000000000200
0000340000000000000000000000000000000000
0000340000000000000000000000000000000403
0000340000000000000000000000000000000310
0200340000000000000000000000000000000620
1201340000000000000000000000000000000120
2205040703040307060000050203030205050420
2311111111111112010000031011111111111124

image image:caves
position 8 6 2 *
