2121212121212121212121212121212121212121
2121211331313131313131313114212121212121
1331313206010400040702020030311421212121
3206020700060401050407010606053014212121
0205000602050064010406630000060630142121
0600000506040205076306050303020702202121
1112030605000000050103020203060606202121
2123120603040607010401040204000010242121
2121231112050707020002010706020020212121
2121212123111111111202010510111124212121
2121212121212121212311111124212121212121
2121212121212121212121212121212121212121

image image:caves
position 8 6 2 *
sprite @13,5 sprite:jigpiece (u32)0
