2121212121212121220605202121212121212121
2121212121212121220500301421212121212121
2121212121212121220706003014212121212121
2121212121212121231202000630142121212121
2121212121212121212312040100301421212121
2121212121212121212122050006033014212121
2121212121212121212122070000030520212121
2121212121212121211332070000000230142121
2121212121212121133206050000080407202121
2121212121212121220307000000000005202121
2121212121212121231207070404010106202121
2121212121212121212312040010111111242121

image image:caves
position 9 6 2 *
door @14,8 map:125 @2,1 0x0000
sprite @9,9 sprite:jigpiece (u32)0
