2121212121212121211332060130311421212121
2121212121212113313204050300022021212121
1331313131313132070107040201052021212121
3203070007050700020702040607042021212121
0105050002070200060200000003062021212121
0002070206050102000404050602102421212121
0003040202060206060007070005202121212121
1112000306020102050304070510242121212121
2123111111111111111111111124212121212121
2121212121212121212121212121212121212121
2121212121212121212121212121212121212121
2121212121212121212121212121212121212121

image image:caves
position 9 7 2 *
sprite @12,6 sprite:jigpiece (u32)0
