2121212121212121212121212121212121212121
2121212121212121212121212121212121212121
2121212121212121212121212121212121212121
2121211331313131313131313131311421211331
2121133200030604040707030404003031313205
1331320201060101030007020602070106040200
3203040307101112000104070205070707070207
0704000510242123120004010201061011111111
0606101124212121231111111111112421212121
1111242121212121212121212121212121212121
2121212121212121212121212121212121212121
2121212121212121212121212121212121212121

image image:caves
position 8 7 2 *
sprite @9,7 sprite:jigpiece (u32)0
