1331313132070000000000000007303131313114
2205070701050000000000000004060102050820
2200000000000000000000000000000000000720
2206000034343434343434343434343400000730
3204000034000000000000000000003400000700
0604000034000000000000000000003400000000
0000000034000000000000000000003400000000
0000000034000000000000000000003400000000
0403000034343434343434343434343400000407
1200000000000000000000000000000000000210
2200040504050401060202050000070404000220
2311111111111111111112040000041011111124

image image:caves
position 7 7 2 *
door @18,1 map:111 @16,4 0x0000
