1331313131313131320500303131313131313114
2205000404060305030700030106070100070420
2202040003040705000603000107070707000320
220001010e0e0201020102000200020703000720
2204060e00040001010007020104070404000520
2202040e07000305010108030105040704000620
3206070e04020300000301050000070503000130
040602050e0e0103020706060406060601000606
0403000600040301000404010703010506040405
1200000504040706020307050603040306060310
2200040504000306040006020500060201070020
2311111111111111111112060210111111111124

image image:caves
position 7 7 2 *
door @10,5 map:111 @15,4 0x0000
sprite @4,9 sprite:jigpiece (u32)0
rspriteres rsprite:usoutheast
