1331313131313131313202043031313131313114
2201030001050103040400000405070505070720
2311111111111111111111111111111111111124
1331142121212121212121212121212121133114
3203303131313131313131313131313131320320
0000030404030107050003000100030203060730
0005070703060504030705020307030002020307
0301101111111111111111111111111112060405
1111242121212121212121212121212123111200
1331313131313131313131313131313131142311
2206000002040206070000030505060605202121
2311111111111112000005101111111111242121

image image:caves
position 5 7 2 *
sprite @18,4 sprite:jigpiece (u32)0
