2121212121212121212121212121212121212121
2121212121212121212121212121212121212121
2121212121212121212121212121212121212121
2121212121212121212121212121212121133114
2121212113313131313131313131313131320320
3131313132010107050003000100030203060730
0404020405020504030705020307030002020307
0301101111111111111111111111111112060405
1111242121212121212121212121212123111200
2121212121212121212121212121212121212311
2121212121212121212121212121212121212121
2121212121212121212121212121212121212121

image image:caves
position 5 7 2 *
sprite @18,4 sprite:jigpiece (u32)0
