2121212121220620212121212121212121212121
2121212121220630313114212121212121212121
2121212121220305000030313131313114212121
2121212121231111120102000505070630142121
3131311421212121231201021011120407301421
0003043031311421133202102421231200023031
0601060700073031320007202121212312000206
0006070604040402030010242121212123111200
1111111112060000011024212121212121212311
2121212123110011112421212121212121212121
2121212121210021212121212121212121212121
2121212121210021212121212121212121212121

image image:caves
position 4 7 2 *
sprite @5,6 sprite:jigpiece (u32)0
