1331313132060000003031313131313131313114
2204010202070000050603030207070701020520
2203340000000000000000000000000000000620
2200340000000000000000000000000000000420
3202340000000000000000000000000000000530
0600340000000000000000000000000000000505
0000340000000000000000000000000000000000
0207340000000000000000000000000000000004
1203340000000000000000000000000000000510
2205343434343434343434343434343434340720
2206000100020601070000070501000704010720
2311111111111112000000061011111111111124

image image:caves
position 4 7 2 *
