2121212122020003072021212121212121212121
2121212123111111112421212121212121212121
2121133131313131313131313131142121212121
2113320504000501030406020104303131142121
3132010600031011120201030107040706303131
0700000200043014231111120400000005050200
0002010200070630313131320100000000000000
0106040203060107000204010103020200040101
1111120607101111111111111111111111111111
2121231111242113313131311421212121212121
2121212121212122020006022021212121212121
2121212121212122060000072021212121212121

image image:caves
position 4 7 2 *
sprite @4,8 sprite:jigpiece (u32)0
