1331313132050000000730313131313131313114
2205060005050000000202070202010306030720
2203000000000000000000000000000000000420
3205000000000000000000000000000000000320
0506000000000000000000000000000000000030
0000000000000000000000000000000000000401
0707000000000000000000000000000000000000
1202000000000000000000000000000000000402
2202000000000000000000000000000000000510
2206000000000000000000000000000000000220
2205010006030100060100000400030300060020
2311111111111111120500051011111111111124

image image:caves
position 3 7 2 *
