2121212122060000000520212121212121212121
2121212122020700020520212121212121212121
2121212123111111111124212121212121212121
3131313131313131313131313131142121212121
0202030003070507020702030301303131313131
0000000000000000000000000001030406030102
0601050204010206050202000000000000000000
1111111111111111111202020106060605000306
2121212121212121212311111111111111111111
2121212121212121133131311421212121212121
2121212121212121220106022021212121212121
2121212121212121220500012021212121212121

image image:caves
position 3 7 2 *
sprite @10,10 sprite:jigpiece (u32)0
