1331313131313131313132020030313131313114
2202030605050705000602050605000101030720
2203000000000000000000000000000000340120
2207000000000000000000000000000000340230
3205000000000000000000000000000000340406
0402000000000000000000000000000000340000
0000000000000000000000000000000000340500
0301000000000000000000000000000000340510
1200000000000000000000000000000000340020
2204343434343434343434343434343434340020
2204000203070301000004030302010102000420
2311111111111112070004101111111111111124

image image:caves
position 2 7 2 *
