2121212121212121212121212121212121212121
2121212113313131142121212121212121212121
2121212122020104202121212121212121212121
2121212123120405202121212121133131313131
3131313114220301201331313131320302010402
0604050630320203303204010404060201060500
0000000406060504060400070500070107060107
0306060006000402020704101111111111111111
1111111111111111111111242121212121212121
2121212121212121212121212121212121212121
2121212121212121212121212121212121212121
2121212121212121212121212121212121212121

image image:caves
position 2 7 2 *
sprite @5,2 sprite:jigpiece (u32)0
