0000000000000000000000000000000000000000
0000000000000000000000000000000000000000
0000000000000000000000000000000000000000
0000000000000000000000000000000000000000
0000000000000000000000000000000000000000
1c0000000000000000000000000000000000001a
2c0000000000000000000000000000000000002a
2c0000000000000000000000000000000000002a
2c0000000000000000000000000000000000002a
2c0000000000000000000000000000000000002a
2c0000000000000000000000000000000000002a
2d1b1b1b1c0000000000001a1b1b1b1b1b1b1b2e

image image:meadow
position 0 -2 1 *
