0403020002030405000302060604020100060402
0605030400050002040106060304030306020602
0105060504050206000103030000000504060006
0100060502000405010203050305060402060505
0504030505030300131310050602020400060501
0400060302030606120103000400010203060601
0402010602050604100005010404000500000305
0103020206050505010006060205040103030601
0501000405010601030305000200010201020206
0401030303040404060102050104040101010402
0304060201030200000405020000050203060400
0500060304010100050001050206020401060001

image image:meadow
position 2 2 1 *
