91919191919191919191919191920101a0a18491
919191919191919191919183a1a200020003a0a1
9191919191919183a1a1a1a20106000205040206
9191919183a1a1a2020106040104030101020303
9191919192000406050002010604050104050000
91919183a2030601060202000306020400060503
919183a202040302060406030302030200010202
a1a1a20604000402000305050103000103050602
0606030503010605030406000506020305050100
0605000301000304060205050003000406010604
0506000301050500000005060102040004060102
0102030301000402010101040001030203010002

image image:meadow
position 3 3 1 *
song song:blood_for_silver
sprite @13,5 sprite:jigpiece (u32)0
