1331313131320400000000000006303131313114
2200050607070500000000000003050306020520
2202000000000000000000000000000000000320
3203000000000000000000000000000000000430
0207000000000000000000000000000000000503
0000000000000000000000000000000000000000
0504000000000000000000000000000000000000
1206000000000000000000000000000000000105
2206000000000000000000000000000000000510
2205000000000000000000000000000000000720
2205070005070105000000000603010600030420
2311111111111206000000000410111111111124

image image:caves
position 1 8 2 *
sprite @12,5 sprite:jigpiece (u32)0
