1331313131313132020005303131313131313114
2203030704030601070002000204060504060420
2200000000000000000000000000000000000520
3203000000000000000000000000000000000130
0001000000000000000000000000000000000001
0000000000000000000000000000000000000000
0000000000000000000000000000000000000706
0604000000000000000000000000000000000110
1200000000000000000000000000000000000220
2203000000000000000000000000000000000720
2203010703070202020503020002070203020220
2311111111111111111112000006101111111124

image image:caves
position 2 8 2 *
sprite @8,5 sprite:jigpiece (u32)0
