1331313131313131320000053031313131313114
2200030504000305030700020202020201040120
2206000000000000000000000000000000000120
3207000000000000000000000000000000000730
0105000000000000000000000000000000000701
0000000000000000000000000000000000000000
0300000000000000000000000000000000000000
1204000000000000000000000000000000000105
2206000000000000000000000000000000000310
2206000000000000000000000000000000000020
2201000404000501000000000300000705070020
2311111111111200000000000510111111111124

image image:caves
position 3 8 2 *
sprite @10,5 sprite:jigpiece (u32)0
