2121212121212121212121212121212121212121
2121212121212121212121212121212121212121
2121212121212121212121212121212121212121
3131313131313131313131313131313131313131
0701060505060104010700030204010700070300
0604020106060105040400050607030400050004
1111111111111111120406101111111204060007
2121212121212121220305202121212312050200
2121212121212121220107202121212123111111
2121212121212121220105202121212121212121
2121212121212121220300202121212121212121
2121212121212121220101202121212121212121

image image:caves
position 3 8 2 *
sprite @10,5 sprite:jigpiece (u32)0
