2121211331313131313131313131311421212121
2121212205060301050603020206043014212121
2121133207030607040202056406040330142121
3131320305000440414142000202070002202121
0005040402000160445153414141420101202121
0000070503030107604451515143620005202121
0003101112020505065051514362010601202121
0610242122020603026044436206071011242121
1124212123120504040150520605102421212121
2121212121231208000150520003202121212121
2121212121212312060150520004301421212121
2121212121212122000350520001032021212121

image image:caves
position 4 8 2 *
sprite @6,7 sprite:jigpiece (u32)0
door @7,9 map:89 @4,8 0x0000
rspriteres rsprite:usouthwest
