1331313131313132070000053031313131313114
2207010703070305060000050001020301050120
2204000000000000000000000000000000000320
3206000000000000000000000000000000000030
0600000000000000000000000000000000000406
0000000000000034340000003434000000000000
0000000000000000003400340000000000000000
0005000000000000000034000000000000000700
1205000000000000000034000000000000000210
2204000000000000000000000000000000000420
2200060504040300000304000000030604050720
2311111111111111111207000000031011111124

image image:caves
position 4 8 2 *
sprite @10,4 sprite:jigpiece (u32)0
