1331313131313132030006303131313131313114
2202050005010702040003030203040103010120
2203000000000000000000000000000000000220
3206000000000000000000000000000000000430
0405000000000000000000000000000000000405
0000000000000000000000000000000000000000
0000000000000000000000000000000000000000
0307000000000000000000000000000000000603
1203000000000000000000000000000000000210
2203000000000000000000000000000000000320
2200070102050104070700000002050607070020
2311111111111111120500000006101111111124

image image:caves
position 5 8 2 *
