2121212121212121212121212121212121212121
2121212121212121212121212121212121212121
2121211331313131142121212121212121212121
2113313200020501301421212121212121212121
3132010603020104002021212121212121212121
0401020210111201002021212121212121212121
0005101124212206013014212121212121212121
1111242121133200060320212121212121212121
2121212121220601020620212121212121212121
2121212121220602040620212121212121212121
2121212121220506041024212121212121212121
2121212121220106062021212121212121212121

image image:caves
position 6 8 2 *
sprite @6,8 sprite:jigpiece (u32)0
rspriteres rsprite:usoutheast
