2121212121212121212122000020212121212121
2121212121212121211332050020212121212121
2121212121212113313207060530142121212121
2121212121211332030201010003202121212121
2121212121212202030010120707202121212121
2121212121212201011024220505303131313131
2121212121212206013031320205030105070405
2121212121212203060004020402040100010607
2121212121212312060706020001050002101111
2121212121212122050104101111111111242121
2121212121212122040010242121212121212121
2121212121212122000420212121212121212121

image image:caves
position 7 8 2 *
sprite @12,7 sprite:jigpiece (u32)0
rspriteres rsprite:usoutheast
