1331313131313131313207000430313131313114
2200030405050606060704000607070404040520
2203000000000000000000000000000000000020
2207000000000000000000000000000000000230
2200000000000000000000000000000000000205
3207000000000000000000000000000000000000
0001000000000000000000000000000000000407
0003000000000000000000000000000000000610
1200000000000000000000000000000000000220
2203000000000000000000000000000000000720
2204020001020000000202030006040701050720
2311111111120200000410111111111111111124

image image:caves
position 8 8 2 *
