2121212121212121212121212121212121212121
2121212121212121212121212121212121212121
2121212121212121212121212121212113313131
2121212121212121212121212121211332060005
2121212121212121212121212121133201040201
3131311421212121211331142113320506061011
0107033014212121212200201332030304102421
0002000430142121212206303203050610242121
1203010301202121212207020507031024212121
2203060105301421212311120604062021212121
2312070600052021212121220706022021212121
2123120702002021212121220206002021212121

image image:caves
position 8 8 2 *
sprite @10,6 sprite:jigpiece (u32)0
