2121212121212121212121212121212121212121
2121212121212121212121212121212121212121
3131313131142121212121212121212121212121
0700070204303114212121212121212121212121
0107030605010730142121212121212121212121
1112070001020306301421212121212121212121
2123120500070200003014212121212121212121
2121231205050407070520212121212121212121
2121212312030204070530142121212121212121
2121212123120704020300202121212121212121
2121212121231112050406301421212121212121
2121212121212123120406002021212121212121

image image:caves
position 9 8 2 *
sprite @6,5 sprite:jigpiece (u32)0
