1331313131313201000000303131313131313114
2203050704030105000000030702000002040720
2200000000000000000000000000000000000720
3202000000000000000000000000000000000020
0201000000000000000000000000000000000620
0000000000000000000000000000000000000020
0301000000000000000000000000000000000020
1207000000000000000000000000000000000620
2204000000000000000000000000000000000520
2201000000000000000000000000000000000120
2201000100070702010403050000020603050220
2311111111111111111112020000061011111124

image image:caves
position 9 8 2 *
