3125312535252535353135252531353131313131
2531313135252531252525253531313531252531
3125352525252531353125353525312535253125
3135353531353531253535353135313531252525
3135353125253131253135352525313131253531
3131313135353123414124312535352523414141
4141412423414142030430253135234142010304
0201014042020600030040414141420202030000
0002430002020001040004000301030400010505
0405010402040200010603060403024304050002
0104010303060204034501010106030502050006
0600020103000301030401040606060004020204

image image:tundra
position 5 0 1 *
sprite @8,7 sprite:jigpiece (u32)0
