2113313131313131313131142113313131311421
1332000000000000000000303132000000003014
2200000000000000000000000000000000000020
2200003400000000000000000000000000000020
2200003300000000000000000000000000001024
2200003400000000000000000000000000002021
2200000000000000000000000000000000002021
2200000000000000000000000000000000003014
2200000000000000000000000000000000000020
2312000000000000000000000000000000000020
2122000000000000000000000000000000001024
2123111111111111111111111111111111112421

image image:meadow
position 0 0 2 *
sprite @9,6 sprite:hero (u32)0
