1331313131313131313132040000063031313114
2203010404020000000504010000020707040420
2200000000000000000000000000000000000120
3205000000000000000000000000000000000520
0104000000000000000000000000000000000620
0000000000000000000000000000000000000020
0000000000000000000000000000000000000120
0501000000000000000000000000000000000420
1205000000000000000000000000000000000220
2202000000000000000000000000000000000220
2204050602070406010504040307040506010120
2311111111111111111111111111111111111124

image image:caves
position 9 9 2 *
sprite @11,6 sprite:jigpiece (u32)0
