2121220505023014211331320204012021212121
2121220005040230313201010700043014212121
2121220500050205040703010003000220212121
2121220701020503040200040301060120212121
2121231207070406050701000104061024212121
2121212200000204070301000200102421212121
2121212311120207010101030110242121212121
2121212121231111111111111124212121212121
2121212121212121212121212121212121212121
2121212121212121212121212121212121212121
2121212121212121212121212121212121212121
2121212121212121212121212121212121212121

image image:caves
position 8 9 2 *
sprite @9,3 sprite:jigpiece (u32)0
