1331313131313132060030313131313131313114
2203010602070007050306060300010707040220
2205000000000000000000000000000000000520
3203000000000000000000000000000000000730
0403000000000000000000000000000000000001
0000000000000000000000000000000000000000
0000000000000000000000000000000000000000
0000000000000000000000000000000000000106
1203000000000000000000000000000000000010
2204000000000000000000000000000000000120
2206030100070707000304070301000502040420
2311111111111111111111111111111111111124

image image:caves
position 7 9 2 *
sprite @11,6 sprite:jigpiece (u32)0
