2121212121212122040730142121212121212121
2121212121212122070505202121212121212121
2121212121211332040401301421212121212121
2121212113313201030306073031142121212121
3131313132030204050701020400202121212121
0202070200040003030301050001202121212121
0000070002060406020705000002202121212121
0704010204060704050702030300202121212121
1111120001010103070402071011242121212121
2121231111111203000610112421212121212121
2121212121212311111124212121212121212121
2121212121212121212121212121212121212121

image image:caves
position 7 9 2 *
sprite @11,6 sprite:jigpiece (u32)0
