2121212121220300022021212121212121212121
2121212121220000003014212121212121212121
2121212121220107000530142121212121212121
2121212121231205010306301421212121212121
2121212121212200040202023014212113313131
2121212121212312000203030230313132020504
2121212121212123120303070706000700060701
2121212121212121220001010301070001030505
2121212121212121231205060405030307101111
2121212121212121212311111111111111242121
2121212121212121212121212121212121212121
2121212121212121212121212121212121212121

image image:caves
position 6 9 2 *
sprite @9,5 sprite:jigpiece (u32)0
rspriteres rsprite:usoutheast
