1331313131313131320205303131313131313114
2205040205030701050402050700000500070220
2206054041414206020207000540414141414220
2204035043616207070104030450515143616220
2204045052060101060406404154515152030120
2205006062050103054041544361616162040720
2207040202050406075043616207050302000620
2200060507030006405452000404030407010720
2200030207040304505152030106020707000220
2202070501060700505152000102050007000120
2202000300000207606162070100060002010020
2311111111111111111111111111111111111124

image image:caves
position 5 9 2 *
sprite @5,4 sprite:jigpiece (u32)0
sprite @14,8 sprite:treasure (u8:itemid)tapemeasure (u8:quantity)0 (u16:fld)0
