1331313131313131320205303131313131313114
2205060105070501050402050006010105050520
2206070303020003020207000207040106070720
2204030102030504070104060606000505050020
2204000203070701040301000604020200020320
2205070103070103070100050000060706000720
2207070607030405040007070407010201050620
2200060507030006070300010204030407010720
2200030207040300030200050106020707000220
2202070501060700040002040102050007000120
2202000300000203040204040100060002010020
2311111111111111111111111111111111111124

image image:caves
position 5 9 2 *
sprite @5,4 sprite:jigpiece (u32)0
