2121212121211332020550520603072021212121
2121212121133201000550520605022021212121
2121211331320401050350534207003014212121
2113313207030103630050515204050720212121
3132000505040607000450515203000720212121
0205020101060706064054515205030620212121
0503050505404206045051436207070020212121
1112030705606206025051520105030120212121
2123120601000504026044520463020520212121
2121231206010207040360620304011024212121
2121212312040205060204000306102421212121
2121212123111111111111111111242121212121

image image:caves
position 4 9 2 *
sprite @6,4 sprite:jigpiece (u32)0
