2121212121212121220502202121212121212121
2121212121212121220301202121212121212121
2121212121212121220505202121212121212121
2121212121212121220205202121212121212121
3131313131313131320300303131313131313131
0603030307000405060204030303020205050001
0504010102070403030302060206050701000502
1111111111111111111111111111111111111111
2121212121212121212121212121212121212121
2121212121212121212121212121212121212121
2121212121212121212121212121212121212121
2121212121212121212121212121212121212121

image image:caves
position 3 9 2 *
sprite @11,6 sprite:jigpiece (u32)0
rspriteres rsprite:usouthwest
