1331313131313202000000000530313131313114
2202030303030704000000000205020003020620
2200000000000000000000000000000000000420
2206000000000000000000000000000000000230
3202000000000000000000000000000000000304
0500000000000000000000000000000000000000
0000000000000000000000000000000000000502
0000000000000000000000000000000000000410
0400000000000000000000000000000000000720
1206000000000000000000000000000000000520
2202020606030105030506020102010104020420
2311111111111111111111111111111111111124

image image:caves
position 3 9 2 *
sprite @11,6 sprite:jigpiece (u32)0
