2121212200052021212121212122000220212121
2121212207002021212121212122060620212121
2121212205052021212121212122020420212121
2121212202002021212121212122030620212121
3131313205073031313131313132050530313131
0203030501020302030405060102050401000503
0707020402040303030003000305040706000406
1111111111111111111111111111111111111111
2121212121212121212121212121212121212121
2121212121212121212121212121212121212121
2121212121212121212121212121212121212121
2121212121212121212121212121212121212121

image image:caves
position 2 9 2 *
sprite @11,5 sprite:jigpiece (u32)0
