1331313131313204000000000530313131313114
2206030607010002000000000306050404070420
2201000000000000000000000000000000000420
2200000000000000000000000000000000000330
3204000000000000000000000000000000000504
0507000000000000000000000000000000000000
0000000000000000000000000000000000000000
0607000000000000000000000000000000000307
1203000000000000000000000000000000000610
2203000000000000000000000000000000000320
2206060601020300030204060002060301040420
2311111111111111111111111111111111111124

image image:caves
position 1 9 2 *
