2121212122020020212121212202052021212121
2121212122010620212121212204072021212121
2121212122040120212121212203002021212121
2121212122020420212121212205002021212121
3131313132040330313131313204053031313131
0005060307070203000605060705010402060002
0303040501030705050505000006020204070204
1111111111111111111111111111111111111111
2121212121212121212121212121212121212121
2121212121212121212121212121212121212121
2121212121212121212121212121212121212121
2121212121212121212121212121212121212121

image image:caves
position 1 9 2 *
sprite @8,6 sprite:jigpiece (u32)0
