2121211331313131313131313131313114212121
2121212200500040000000005000500020212121
2121212200600000005143006000700030311421
2113313200600051427300006000000000002021
2122000000600060000000416300500000002021
2122000000700060001516006000600000002021
2122000000000060002526006000600010112421
2123111200514263000000006000600020212121
2121212200700060004142427300600020212121
2121212200000060000000000000600020212121
2121212200400071430041424242730020212121
2121212311111111111111111111111124212121

image image:battle_labyrinth3
position 0 6 0 0
battlemark @17,4 (u16)2
battlemark @15,4 (u16)4
battlemark @2,5 (u16)1
battlemark @4,5 (u16)3
battlemark @9,6 (u16)5
battlemark @9,5 (u16)5
battlemark @10,5 (u16)5
battlemark @10,6 (u16)5
