9192404141414141414201020040414141414141
9192010604040405030105000003030406030204
9192000004050105060104040405060306010400
83a2050201020100030005000005050303000304
9206010601040003000300050103060001010105
9203060303030502040104050502020106000302
9200060003050302000100060001000000030101
9200430100000303060004050503010104000504
9200020204010503000000030106020400060002
9381818181818181818205000505060506010502
9191919191919191919381818181818181818181
9191919191919191919191919191919191919191

image image:meadow
position 4 7 1 *
sprite @13,4 sprite:jigpiece (u32)0
debugmsg "farm"
