9240414141414141414201020040414141414141
9204020604040405030105000003030406030204
9200050004050105060104040405060306010400
9202020201020100030005000005050303000304
9200020601040003000300050103060001010105
9203060303030502040104050502020106000302
9200060003050302000100060001000000030101
9200430100000303020000040003010104000504
9206000003000503020402050206020400060002
9205000503010500010105000302060506010502
9381818181818181818181818181818181818181
9191919191919191919191919191919191919191

image image:meadow
position 4 7 1 *
sprite @13,4 sprite:jigpiece (u32)0
debugmsg "farm"
