9191919191919191919191919191919191919191
9191919191919191919191919191919191919191
a1a1a1a1a1a1849191919191919183a1a1a1a1a1
020205020601a0a1a1a1a1a1a1a1a20205030106
0203000100060501050506010301020104060200
0100050400030401040304000302020201010406
0603020402060106000306000202010501040202
0603010404050205040602040602010500000504
0101050000000302020404000102010505030005
0404060406010605000602010203020206040205
0504010201010106050202000502040500040401
0103050003020405000304030604050405020305

image image:desert
position 5 3 1 *
song song:blood_for_silver
