2341412425353131312523414141414141414141
3206034041414141414142020200020103040000
3201040106020301050300060005000600040501
3205000204030204040005010201010604050600
3200050404010406030603050401440200060402
3200000205040503040105030404040300040002
3204000002030614040602050103030200060200
3201010604030405000003010101000101030003
3203040502020606020005050603060500010203
3322030604030502030403060402010204030200
3132040304000603060104020505010500000006
3133212121212121212121212121212121212121

image image:meadow
position 0 0 3 *
sprite @7,5 sprite:hero (u32)0
door @7,6 map:9 @7,6 0x0000
