2121212121212122010603040020212121212121
2121212121212122050606000720212121212121
2121212121212123120503031024212121212121
2121212121212121220603052021212121212121
2121212121212121220401002021212121212121
2121212121212121220605002021212121212121
2121212121212121220406042021212121212121
2121212121212121231201102421212121212121
2121212121212121212207202121212121212121
2121212121212121212311242121212121212121
2121212121212121212121212121212121212121
2121212121212121212121212121212121212121

image image:icepalace
door @10,8 map:17 @9,2 0x0000
position 2 5 7 0
sprite @8,1 sprite:jigpiece (u32)0
song song:igloo
