2121212121212122000507060420212121212121
2121212121212122020707020220212121212121
2121212121212122000500070620212121212121
2121212121133132030105030330311421212121
2121212121220307040504040303062021212121
2121212121220105020001010000022021212121
2121212121231112000401050110112421212121
2121212121212122010600030620212121212121
2121212121212122050002030020212121212121
2121212121212122060304020420212121212121
2121212121212122030603000120212121212121
2121212121212122070305010020212121212121

image image:icepalace
position 2 2 7 *
sprite @14,4 sprite:jigpiece (u32)0
song song:igloo
