2121212121212121212121212121212121212121
2121212121212121211331142121212121212121
2121212121212121212201202121212121212121
2121212121212121212207202121212121212121
2121212121212121212205202121212121212121
2121212121212121133206301421212121212121
2121212121212121220300062021212121212121
2121212121212121220202072021212121212121
2121212121212121220604042021212121212121
2121212121212121220601032021212121212121
2121212121212121220307002021212121212121
2121212121212121220007002021212121212121

image image:icepalace
position 2 0 7 *
sprite @9,8 sprite:jigpiece (u32)0
song song:igloo
sprite @10,6 sprite:icedragon (u8:seq)6 (u24)0
