3132030004050103060402010606040204024024
4142050500000401050300060404000206000440
0602060600010303020004040101020301000006
0105040006030000050502060500020506040006
0606010303020001000100050302030201000400
0300030002050001020601060001040301020000
0105010003010604030605040605030500000004
0106050301050204010306050003060505060501
0005000306000002000203050505000201060301
0604060003030000050203030506040600060303
0206030006020006040003020503050605030600
2121212122010203000002050405202121212121

image image:meadow
position 3 7 1 *
sprite @9,5 sprite:jigpiece (u32)0
