0100020005040205050605040202030203020205
0506050204020104000000050606060501060402
0405060100050403030006000604030100030304
0306000401000201010201010504040103020300
0102030604000002030106040404030103020401
0000040506040301020206060100000206010305
0300030601030105060303050206000003010004
0605020300040006030103060204030004010602
0100000400060200040304050206030505000505
0402030202010602020000030105000404000003
0501050503010304040101000503020001050205
0003020300060301050102020401030306000002

image image:desert
position 5 4 1 *
