4141414141414141414141414141414141414124
0600030304030303010103040600060106050330
0503010302030406000202020304010002030530
0204050044030105060004060205010600010130
0406000506030402010402010404030600040330
0405020304050306060406050303010105040030
0606000500010003020645060404000405020530
0500000203060105030306030006020005030030
0202040401050303030102030305060504030530
0102010301010300030101040201060306000330
0120212122022021212122010400060402030130
2134353533213431312533212121212121212134

image image:meadow
position 1 0 3 *
