919191919191919183a1a1a1a184919191919191
91919183a1a1a1a1a200000300a0a18491919191
9183a1a20005030006054305040502a084919191
83a2050103030000040305040200000090919191
92060403030203050380818182040305a0849191
920503000203048081949183a200040005909191
9206010003028094919183a20602010300909191
920504030104a0a1a1a1a2010104450306909191
9382060306000605060404030501000001909191
9193820003020000050203030200030080949191
9191938182000006050304038081818194919191
9191919192030203008081819491919191919191

image image:meadow
position 3 7 1 *
sprite @4,5 sprite:jigpiece (u32)0
rspriteres rsprite:southjungle
race @19,11 1 1
