2121212202040101030202000401063014212121
2121212311120306000303010605070230142121
2121212121231112030206020006040406303131
2121212121212123111206010000000704060502
2121212121212121212311120402050304030601
2121212121212121212121231111111203060305
2121212121212121212121212121133203000000
2121212121212121212121212113320707040107
2121212121212121212121211332060200030403
2121212121212121212121133206050502040606
2121212121212121212113320505030501000710
2121212121212121212122050107040004041024

image image:icepalace
position 1 3 7 *
sprite @12,4 sprite:jigpiece (u32)0
song song:igloo
