2121212202040101030305050300303114212121
2121212311120306000618191919191a30142121
21212121212311120306283d1d3d2d2b1a303131
2121212121212123111238391c1d1d2d2b191919
212121212121212121231112383939391c293d3d
21212121212121212121212311111112282d2d1d
212121212121212121212121212113322829292d
212121212121212121212121211332182c291d2d
2121212121212121212121211332182c2929293d
21212121212121212121211332182c1d291d1b39
212121212121212121211332182c2929291b3a10
212121212121212121133205281d1d1d1b3a1024

image image:icepalace
position 1 3 7 *
sprite @12,4 sprite:jigpiece (u32)0
song song:igloo
