2121212121212121212203202121212121212121
2121133114211331142206202121212121212121
2121220630313200303200303114212121212121
2121220006070002030702060430142121212121
2121220105000207070606060507303114212121
2121231112070404020504020403010530313131
2121211332030700070600030405070200000304
2121212207060702000003070000030001020701
2121212203031011111206010006000300070301
2121212311112421212312020000020300060702
2121212121212121212123120000050502050407
2121212121212121212121231202050303010006

image image:icepalace
position 0 1 7 *
sprite @4,8 sprite:jigpiece (u32)0
song song:igloo
