2121212121212113313131313131142121212121
2121212121212122000204060507202121212121
2121212121212122030300070003202121212121
2121212121212122010305020500202121212121
2121212121211332010104000004202121212121
2121212121133204010500000303202121212121
1331142113320707060010111111242121212121
2200303132070205011024212121212121212121
2206070605040102102421212121212121212121
2207060602060710242121212121212121212121
2202010700031024212121212121212121212121
2206000606042021212121212121212121212121

image image:icepalace
position 1 1 7 *
sprite @12,2 sprite:jigpiece (u32)0
song song:igloo
sprite @10,2 sprite:icedragon (u8:seq)3 (u24)0
