2121212121212121133201060705040305102421
2121212121212113320200060007060710242121
2121212121211332000007050605061024212121
2121212121133207070706040006102421212121
2121212113320004020700050610242121212121
2121211332040006010505071024212121212121
2121133206030505070501102421212121212121
2113320507070601060210242121212121212121
1332000506050205031024212121212121212121
3200030507000306102421212121212121212121
0700050202010310242121212121212121212121
0303010300041024212121212121212121212121

image image:icepalace
position 1 4 7 *
sprite @10,6 sprite:jigpiece (u32)0
song song:igloo
