0706060707102421212121212121212121212121
0002060607301421212121212121212121212121
0001070701033031142121212121212121212121
0101060203000307301421212121212121212121
0606030107050401052021212121212121212121
1112060400070204043014212121212121212121
2123120600040702000230142121212121212121
2121231204060500050200202121212121212121
2121212311111112070205202121212121212121
2121212121212123111111242121212121212121
2121212121212121212121212121212121212121
2121212121212121212121212121212121212121

image image:icepalace
position 1 5 7 *
sprite @9,7 sprite:jigpiece (u32)0
song song:igloo
sprite @6,5 sprite:icedragon (u8:seq)2 (u24)0
