2121212121212121212121220300030005050100
2121212121212121212113320003050104000405
2121212121133131141332050205030504040706
2121212121220607303205000503030601070601
2121212121220706040502070007000510111206
2121212121231200040200040503021024212311
2121212121212200070404040210112421212121
2121212121212312070002101124212121212121
2121212121212123111111242121212121212121
2121212121212121212121212121212121212121
2121212121212121212121212121212121212121
2121212121212121212121212121212121212121

image image:icepalace
position 0 5 7 *
sprite @6,3 sprite:jigpiece (u32)0
song song:igloo
