0002000505050302030402000505050602020001
0206050001030500020406030104050000050306
0603010401060401050000000501010002040501
0502030504040501060303020401010203050406
0500010402060306000406050202020302020100
0603020600010606010302000103030503000205
0505000104030204050503050504050300040300
0603050305020206030402050303040003010301
0402000505010004040100000002030300010406
0205060005030002040304060603020604000104
0605000400050503010302000000030201060600
0403000503060101030000050206000003020500

image image:desert
position 4 4 1 *
sprite @9,5 sprite:jigpiece (u32)0
song song:blood_for_silver
