0106010400010504020205060400000205023025
0502000101040002000304050105030401004041
0404010601000000050203000501050401000500
0401030204040106030000060504060104010504
0202040203060104000602010002030200010606
0204030604060602020002060600000501010401
0003000602020000060306040506050103010200
0405030505000100020206040000020501040200
0603030603050005060003030103030400000505
0503000403040504010506020301030406000505
0302050000030405030206020005040000010101
2121212121212202010004020000202121212121

image image:meadow
position 2 7 1 *
sprite @8,4 sprite:jigpiece (u32)0
