0000000000000000000000000000000000004343
0000000000000000000000000000000000004343
0000000000000000000000000000000000000000
0000000000000000000000000000000000000000
0000000000000000000000000000000000000000
0000000000000000000000000000000000000000
0000000000000000000000000000000000000000
0000000000000000000000000000000000000000
0000000000000000000000000000000000000000
0000000000000000000000000000000000000000
0000000000000000000000000000000000000000
4343434343434343434343434343434343434343

image image:meadow
position 2 7 1 *
