0106010400010504020205060400009091919191
0502000101040002000304050105019091919191
0404010601000000050203000501019091919191
0401030204040106030000060505059091919191
0202040203060104000602010000809491919191
0204030604060602020002060206909191919191
0003000602020000060306020380949191919191
0405030505000100020004028094919191919191
0603030603050102020080819491919191919191
0602010000040480818194919191919191919191
8181818181818194919191919191919191919191
9191919191919191919191919191919191919191

image image:meadow
position 2 7 1 *
sprite @8,4 sprite:jigpiece (u32)0
