2531312341414141414141414141414141243531
3123414204000500040405020600050602402431
3132060000040102000103060102050106014024
2342020305020203060402040414050500000330
3202030003010206060006060403030606000230
3204050103000001030604050201060101040530
3203000200000200040202060403030502060230
3200050602030102050304060005060504010530
3201010001040200060406040402060602060330
3201020504050400020102020201050103040530
3203050203060305060204050305030605052034
3321220106040301020600050402040100203435

image image:meadow
position 0 0 4 *
sprite @8,4 sprite:hero (u32)0
door @13,3 map:7 @13,3 0x0000
