2121212121220203010330142121212121212121
2121212121231202010606301421212121212121
2121212121212203060600013014212121212121
2121212121212312040504020230142121212121
2121212121212122060207050006301421212121
2121212121212123120400020703003014212121
2121212121212121231205030204020730142121
2121212121212121212200070201050102301421
2121212121212121212312050301040105013014
2121212121212121212122050202020002000030
2121212121212121212123120206070704030301
2121212121212121212121220100050203010205

image image:icepalace
position 0 4 7 *
sprite @11,9 sprite:jigpiece (u32)0
song song:igloo
