2121212121212121212121212121212121212121
2121212121212121212121212121212121212121
2121211331313131313114212121212121212121
2121212201050406040520212121212121212121
2121212206060205080220212121212121212121
2121212200000406020120212121212121212121
2121212201040707020420212121212121212121
2121212312070410111124212121212121212121
2121212122070020212121212121212121212121
2121212123120630142121212121212121212121
2121212121220300301421212121212121212121
2121212121220404072021212121212121212121

image image:icepalace
position 0 3 7 *
sprite @5,4 sprite:jigpiece (u32)0
door @8,4 map:225 @11,9 0x0000
song song:igloo
