2113320401061024212121212121212121212121
1332060405102421212121212121212121212121
3203060710242121212121212121212121212121
0306001024212121212121212121212121212121
0003102421212121212121212121212121212121
1111242121212121212121212121212121212121
3131313131142121212121212121212121212121
0702060705303114212121212121212121212121
0104070303060030311421212121212121212121
1201020103010602003031142121212121212121
2312030006000100020005303131142121212121
2123120106010702010607030302202121212121

image image:icepalace
position 3 3 7 *
sprite @6,8 sprite:jigpiece (u32)0
song song:igloo
