2121231205060005040102070004303131142121
2121212312030602020507030000060507303114
2121212123120702050707050600040002040330
2121212121231207030402070007040706070102
2121212121212312020005070001040705030003
2121212121212123120000040403040403000102
2121212121212121231203020405000210120306
2121212121212121212312000000020120231111
2121212121212121212123120007070230142121
2121212121212121212121220707070701202121
2121212121212121212113320101020503202121
2121212121212121212122030700000304202121

image image:icepalace
position 3 4 7 *
sprite @15,5 sprite:jigpiece (u32)0
song song:igloo
