2121231205060005040001000109202121212121
2121212312030602071011111111242113313114
2121212123120702032021133131313132030330
2121212121231207013031320907050006030102
21212121212123120b0207060102050705030003
2121212121212123120300040403040403000102
2121212121212121231203020405000210120306
2121212121212121212312000000020120231111
2121212121212121212123120007070230142121
2121212121212121212121220707070701202121
2121212121212121212113320101020503202121
2121212121212121212122030700000304202121

image image:icepalace
position 3 4 7 *
sprite @15,5 sprite:jigpiece (u32)0
song song:igloo
switchable @8,4 (u16:fld)icedoor1
stompbox @12,3 (u16:fld)icedoor1
treadle @13,0 (u16:fld)icedoor1
