2341420604050400060103010104030501404124
3205050204030205010301020301000305020230
3206020500050101020606060605050401050530
3205050400030101000504010302010200002034
3200060505060404010601050201030200033035
3203010303010601030103050506020203043025
3322060300040200050005010201050204003031
3532040002050605000401020505030006023025
2532030203010000040500010402000000043035
2532040006000500000104000505030404203435
3533220301010501010104010500030620342525
3135332121212121212121212121212134253531

image image:meadow
position 0 1 4 *
