0104050104040104000506010206050502000606
0401010105020106040406030000010306020200
0102040402000106000206000104060406000601
0403040601020403050501020005030501010101
0503020503040604020106010403060600000505
0006030100060301060102040006040303050506
0401040601020505050103050201000203040602
0505060100000100050305050402010001000606
0503060201000002060602030002040200030104
0300040401030601040002050402050500060100
0403000302010204010303040300020405010400
0401020000030105050202010005000003030404

image image:meadow
position 3 4 1 *
sprite @10,5 sprite:jigpiece (u32)0
song song:blood_for_silver
