0200000104000003000104000305040205030206
0602010006020201030000040002020600050403
0000020605000306060504010106010000010103
0303040500030644434504020100040304010602
0403050102004544010404040502000604020202
0004000204034506060000040600020304030405
0502000605024304000606010301060600000303
0500060505050602020401060100050602060403
0405020004040600040304010006060003040206
8182060002060006040202040005050300050403
9193818181820002060301020304058081818181
9191919191938181818181820605809491919191

image image:meadow
position 1 7 1 *
sprite @9,5 sprite:jigpiece (u32)0
