2121212121212121212121212121212121212121
2121212121212121212121212121133131142121
2121212121212121212121211331320701202121
2121212121212121212121133204050310242121
2121212121212121212113320300101124212121
2121212113313131313132050202202121212121
2121211332020306020400030610242121212121
2121212203030706060704000730313114212121
2121212312060306060703050702010320212121
2121212123111111120304050302000420212121
2121212121212121220003061011111124212121
2121212121212121220705102421212121212121

image image:icepalace
position 3 0 7 *
sprite @4,7 sprite:jigpiece (u32)0
song song:igloo
