2121212121212121212121212121212121212121
2121133114212121212121212121212121212121
2121220220212121212121212121212121212121
2121220220212121212121212121212121212121
2121220030142121212121212121212121212121
2121220003202121212121212121212121212121
2121220501301421212121212121212121212121
2121220500002021212121212121212121212121
2121231207032021212121212121212121212121
2121212204073014212121212121212121212121
2121212207010520212121212121212121212121
2121212312060020212121212121212121212121

image image:icepalace
position 4 0 7 *
sprite @3,2 sprite:jigpiece (u32)0
song song:igloo
