2121212121212121212200012021212121212121
2121212121212121133205023014212121212121
2121212121212121220601060220212121212121
2121212121212121231201001024212121212121
2121212121212121212202002021212121212121
2121212121212121212312032021212121212121
2121212121212113313132013031311421212121
2121212121212122010107060503072021212121
2121212121212123111112021011112421212121
2121212121212121212122072021212121212121
2121212121212121212122012021212121212121
2121212121212121212123112421212121212121

image image:icepalace
position 4 2 7 *
sprite @9,7 sprite:jigpiece (u32)0
song song:igloo
