3525252525253525313532010205020003030000
2525312535313535313533220202050503040401
2531312535234141243131320300000003000302
3531353123420305402431320603004302000105
3531352342020600004041420201010005050600
3531253200000204000604050004010506050104
2531253204010100000602011311202121212206
3125353322160600111111131112404141243321
3535312533212213101311131313121012404141
4141414141414211121110121010101310121011
1110101111111013131310101011131012131110
1113111013121111121211111311121213131111

image image:meadow
position 0 7 1 *
sprite @7,4 sprite:jigpiece (u32)0
root @17,0 (u16:fld)root3
root @19,3 (u16:fld)root3
root @18,3 (u16:fld)root3
root @17,3 (u16:fld)root3
root @17,2 (u16:fld)root3
root @17,1 (u16:fld)root3
door @5,7 map:236 @6,7 0x0000
