3525252525253525313532010205020003030000
2525312535313535313533220202050503040401
2531312535234141243131320300000003000302
3531353123420305402431320603004302000105
3531352342020600004041420401010005050600
3531253200000204000600010605030601000001
2531253206010200000605060405030002010001
3125353204000302131111100002010500050501
3535313200000405131113120406808182030101
4141414203020304030300010000909193818181
1110101312010001020605000180949191919191
1113111011121180818181818194919191919191

image image:meadow
position 0 7 1 *
sprite @7,4 sprite:jigpiece (u32)0
root @17,0 (u16:fld)root3
root @19,3 (u16:fld)root3
root @18,3 (u16:fld)root3
root @17,3 (u16:fld)root3
root @17,2 (u16:fld)root3
root @17,1 (u16:fld)root3
