4300000000000000000000000000000000000000
4300000000000000000000000000000000000000
4300000000000000000000000000000000000000
4300000000000000000000430000000000000000
4300000000000000000043430000000000000000
4300000000000000000000000000000000000000
4300000000000000000000000000000000000000
4300000000000000000000000000000000000000
4300000000000000000000000000000000000000
4300000000000000000000000000000000000000
4300000000000000000000000000000000000000
4343434343434343434343434343434343434343

image image:meadow
position 0 7 1 *
