3525252525253525313532010205020003030000
2525312535313535313533220202050503040401
2531312535234141243131320300000003000302
3531353123420305402431320603004302000105
3531352342020600004041420401010005050600
3531253200000204000600010605030601000001
2531253206010205000000020205030002010001
3125353204000300202121220302010500050501
3535313200000404404141420406808182030101
4141414203020305050006010500909193818181
1110101312010001020605000180949191919191
1113111011121180818181818194919191919191

image image:meadow
position 0 7 1 *
sprite @7,4 sprite:jigpiece (u32)0
