3531353535252342050030253131313525252525
2525253135253203000530352531352531353525
3125353535313205000240414141414141414141
3535234141414205000402000600000202060003
4141420105060202050000000401020601040101
0106040200000000140500050520212121212121
0502000000000002000302060140242525313125
2122010102000000000404060203303125253131
2533212204000503000000060001302525312535
3531353321212205050203012021343531353535
3531252531313321220203203431253531252525
2531252535353525320105303135313535352525

image image:meadow
door @8,5 map:start @16,10 0x0000
position 0 0 10 *
