3200040300000601000005030205030204020403
3201060102060101040100050503000303040405
3202060604010501040406060604010104020104
3200000600060006040002020000000303060001
3205000000060300060301040403040203010100
3206040202064545000400000002060202020502
3201000102050243454544444305010006060004
3206000000000502010106000501010404010006
3204040103030606050000040604000305000304
3206000103050306030001000306040102030304
3203030006040504050503050302000003000600
3203010001030501030602000304060200040401

image image:meadow
position 0 6 1 *
sprite @11,4 sprite:jigpiece (u32)0
