9191919200010600030200000404040506040001
9183a1a200010106020403030205040101030303
a1a2050506010606020605050401030502020500
0306030400060205060503050300020406010203
0506020001000005030105030403030401020001
0401030102030306040000030300000604020304
0105020300040404050300000001010404030604
0003020601060005040004030105060205040003
0600000202020003010601020406040401040303
0604060303030505050602060203060404050504
0204000202010605060404060002050304010006
0101060200060206020103060104050306010204

image image:desert
position 1 4 1 *
sprite @10,6 sprite:jigpiece (u32)0
song song:blood_for_silver
