9191919191919191919191919191919191919191
9191919191919191919191919191919191919191
9191919191919191919191919191919191919191
a1a1a1a1a1a1a1a1a1a1a1a1a1a184919183a1a1
0002030402040106050600010104a0a1a1a20100
0000000000000000000000000002010106000500
0106050106020204000305030402030202050603
2121212121212122000020212121212121212121
3131353131352532050530312525353535353525
3125313131313532020530253535313135353125
3135352525252532030230313531313531353131
3125353535352532020330312525253125313525

image image:meadow
position 0 -2 10 *
sprite @13,4 sprite:jigpiece (u32)0
