4300000000000000000000000000000000000000
4300000000000000000000000000000000000000
4300000000000000000000000000000000000000
4300000000000000000000000000000000000000
4300000000000000004343434300000000000000
4300000000000000434300004300000000000000
4300000000000000004343434300000000000000
4300000000000000000000000000000000000000
4300000000000000000000000000000000000000
4300000000000000000000000000000000000000
4300000000000000000000000000000000000000
4300000000000000000000000000000000000000

image image:meadow
position 0 4 1 *
