3200000000039091919191919191919191919191
320000000005a0a1a1a1a1a1a184919191919191
42050000000302000601040103a0849191919191
0002000000000000000000000305a0a1a1a1a1a1
0000000000000000000000000003000103030106
0000000000000000010502060200000000000000
0000000000000000054403440500000000000103
0400050000000000050503040200000006030420
2122050405040000000000000000000500202134
3533212122050605000000000006012021343131
2525252533212202020200040304203435353131
3135252535353321220600052021343125253131

image image:meadow
position -1 -2 10 *
