9191919191919191919191919191919191919191
9191919191919191919191919183a1a1a1a1a1a1
919191919183a1a1a1a1a1a1a1a2050505010302
a1a1a1a1a1a20201050204050405040403060103
0503050506050005010302040102000500000104
0105010005040505030305020505020204040204
0406060300000106030201010302010103060603
0006000403060201040501000501020202050203
0102010204030403050005040004040604040102
0303020203030102040502010201010004040502
0205010101050004010105030500010103020500
0000060006030603030002060406030201020004

image image:desert
position -1 4 1 *
sprite @10,6 sprite:jigpiece (u32)0
song song:blood_for_silver
rsprite (u16)0 sprite:koala (u8)100 (u24)0
