0506020305040303060501010604050600040200
4302010602000503020003000500010600000005
0400020003010301020205050302000401010000
4506020002020305000501030004050502010503
0302040000010500030605040405050302060100
4406050000010304010200010400040500020000
0503000502050601000305020404030002010300
4500020604000106050300000304010200020501
0104010402040002010000020106040206010000
4503000405010501030106000006010104040404
0200060402040402030205010003020406020600
2205430044014404430545034400450044054404

image image:meadow
position -1 2 1 *
song song:toil_and_trouble
sprite @9,5 sprite:jigpiece (u32)0
