4141414141414141414141414141414141414141
0200050602060506060004020506040105020002
0205000000000000000000000000000000000000
0100000000000000000000000000000000000000
0600000000000000000000000000000000000000
0003000000030203020505020606060300000000
0004000000058081818181818181820400000000
2204000000039091919191919191920300000000
3205000000059091919191919191920100000000
3200000000059091919191919191920304030203
3206000000059091919191919191938181818181
3202000000009091919191919191919191919191

image image:meadow
position -1 -3 10 *
sprite @15,9 sprite:jigpiece (u32)0
