9191919191911591919191919191919191919191
9191919191911591919191919191919191919191
9191919191911591919191919191919191919191
9191919191911591919183a1a1a1a1a1a1a1a1a1
91919191919115a1a1a1a2010205020105010106
9191919183a11506010501030102040404000601
a1a1a1a1a2000502060101020301040301050203
0405060104050005060004060502040402050004
0503020602040002050203010105000400020404
0404010001010100000603020002010001040505
0405000004040603000504050002000302000606
0200000201010306020106020303020205030001

image image:desert
position -2 4 1 *
sprite @9,6 sprite:jigpiece (u32)0
song song:blood_for_silver
