32050601000400040101020104020304a0a1a1a1
3205060000020305020000030004060306050501
3202000205000000040004030105020003040203
3200000104000201050005004404050201000403
3204060406050001010400054300040406000601
3202050005040603020403064501040601030106
3200020100050000040503024504030204000003
3205060206040343454444454303010000030600
3203060600030606060505040102000002060000
3206040103040100010001050001060304020600
3202010605020405050500020400060005030100
3204050204030201050503020502000000010001

image image:meadow
position 0 2 1 *
sprite @8,4 sprite:jigpiece (u32)0
