3206040206020104050602909191919191919191
3205000206020006060501a08491919191919191
320100000005030206060006a0a1849191919191
3206060001050001010600000400a08491919191
3205030006050206050004010400049091919191
320001010603020444434404050000a084919191
3202000104020100440043010200030690919191
3205020002030004434545020202000290919191
3204000403030105040606050306050290919191
3201050604050104000602000300050290919191
3205000201030000000205050502000290919191
3201050103010601050605040103000490919191

image image:meadow
position 0 1 1 *
sprite @13,6 sprite:jigpiece (u32)0
