0506040001040600060003000506010400000001
0606030005040306010003030001040202030203
0404040506040200000302040102000400020001
0101060204040106000103000201020405060404
0205020404030305050006000502050405050605
0104030001020001050203040605060401030002
0306040401050402050300060205010206050503
0504000300060206020001050004010100030006
0406050104060401060503000202020206000302
0200040101060106030605010604010304030504
0603040104040400030606010503020405000202
0200020600060106010200010104040205010604

image image:desert
position -1 5 1 *
rsprite (u16)0 sprite:koala (u8)100 (u24)0
