4300000000000000000000000000000000000000
4300000000000000000000000000000000000000
4300000000000000000000000000000000000000
4300000000000000000000000000000000000000
4300000000000000000000000000000000000000
4300000000000000434343000000000000000000
4300000000000000430043000000000000000000
4300000000000000434343000000000000000000
4300000000000000000000000000000000000000
4300000000000000000000000000000000000000
4300000000000000000000000000000000000000
4300000000000000000000000000000000000000

image image:meadow
position 0 1 1 *
