4141242525253125353525253125313125253531
0204404124353135253131312525353531234141
0001030340414141414141242523414141420600
0000000106040206030300404142060401010200
0000000000000000030100040203060000000000
0000000000000000058082040000000000000000
0000000000000000009092000000000000000000
0000000000000000039092030000000000000000
0000000000000000039092030000000000000000
0101010104000604069092030204010400010003
8181818181818181819493818181818181818181
9191919191919191919191919191919191919191

image image:meadow
position 1 -3 10 *
sprite @8,9 sprite:jigpiece (u32)0
