0501000304060603000106040604050606060300
0100040306040606020102010504050502010302
0203040600020506050401010201020006000604
0404040601050600030602030000040000030406
0500000005060105010204060605030601040100
0601030302000305020300020003000306030604
0303050506000206050605030505060002000402
0404040505000403010500020501010202000205
0001020002000200050005000005050003050204
0104020105020101050302030404060003060100
0003020005020202000500030104000604020106
0103060604050600060602060306030102050300

image image:desert
position 0 5 1 *
