3135352525234141414141414141243523414141
4141414141420503050305040501404142060400
0405060306030100000000000004030205020000
0000000000000000000000000000000000000000
0000000000000000000000000000000000000000
0000000000000000000000000000000000000000
0000000000000000000000000000000000000000
0000040101000500040000000000000000000000
0301068081818182020401000000000000000000
0480819491919193818205010000000000000000
8194919191919191919382050000000000000000
9191919191919191919192060000000000000000

image image:meadow
position 2 -3 10 *
