a184919191919191919191919191919191919191
00a0a1a1a1a18491919191919191919191919191
060002000301a0a1a18491919191919191919191
040305000003000006a084919191919191919191
02040205060603050300a0849191919191919191
0102020006030000434545a08491919191919191
0500050403000006430001009091919191919191
0006060603050204454405439091919191919191
060606030606040104040202a084919191919191
0605040502030600050503000690919191919191
05020402060503030000000103a0849191919191
0302060000010501060406040605909191919191

image image:meadow
position 1 2 1 *
sprite @9,6 sprite:jigpiece (u32)0
