0006060500040503030306060102060005040306
0205040403030302040606060602050003040404
0003020201010305030005060003060102000100
0500030401040000020203050404050203020002
0204010506010200000301000102030304050300
0002000106000501040205000506060305000603
0400020405060506060301040306040403000002
0100030203000102020504050006000600060406
0202040406030403020006040306050002000200
0403040101060205030300030301060502030000
0406020603040506040000060501010601030201
0003010401060203020001030306030003050506

image image:desert
position 1 5 1 *
rsprite (u16)0 sprite:koala (u8)100 (u24)0
