a1a1a1a1a1a1a1a1a1a1a1a1a1a1a1a200020004
0602050000000501050303030103010305050506
0502010000030001010103050004040505000602
0505020004020204050601000401060201030601
0302040103050401000303450004010305050480
0004020205004300020305034306030105058094
0001060003014306000402034501020400059091
0204020501054544000500454301000503019091
0203020605010545434543440105050002809491
0000020003030200000004030300020304909191
0201000500010206020300000300020080949191
0405040606040606000303000602050290919191

image image:meadow
position 2 3 1 *
sprite @9,5 sprite:jigpiece (u32)0
