9191919191919191919191919183a1a200020004
9191919191919191919183a1a1a2010305050506
919183a1a1a1a1a1a1a1a2060503020505000602
a1a1a20002000500060101000601060201030601
0500050201020000000306030403010305050480
0401032022050601020301050002030105058094
2121213432004405060604040504020000059091
4141414142000606050200060300060280819491
0301020003060505000402040404008094919191
0000020005000003030201808181819491919191
0000030404808181818181949191919191919191
8181818181949191919191919191919191919191

image image:meadow
position 2 3 1 *
sprite @9,5 sprite:jigpiece (u32)0
rspriteres rsprite:isthmus
