0000000000000000000000000000000000000430
0000000000000000000000000000000000000130
0000000000000000000000000000000000000330
0000000000020002010201020304000000000430
0000000006012021212121212206000000000630
0000000000203425313535353202000000000130
0000000005303535353535313200000000000630
0000000006302525312525234201000000000030
0000000000404141414141420505000000000330
0000000005030103010606010000000000000630
0000000000000000000000000000000000000430
0000000000000000000000000000000000000230

image image:meadow
position 3 -2 10 *
