0000000000000000000000000000000000000630
0000000000000000000000000000000000000030
0000000006030000000000000000040600000130
0000000004450200000000000000034505000330
0000000000020600000000000000040404000330
0000000000000000000000000000000000000630
0000000000000001030600000000000000000130
0000000000000006440000010404000000000530
0000000000000002050000034501000000000030
0000000000000000000000000406000000000530
0000000000000000000000000000000000000330
0000000000000000000000000000000000000430

image image:meadow
position 3 -1 10 *
