a1a1a1a1a1a1a184919191919191919191919191
03040205020605a0a1a1a1a18491919191919191
060002060102050106010603a0a1849191919191
0605000301060501040206060604a08491919191
040401000205042021212201000200a084919191
0103010402030130353132050206000290919191
0301000506030540243532040406030690919191
0204010004000402404142040102058094919191
0601040406040101050205020404039091919191
0403000306020002000405050406809491919191
0600000306010402040302010080949191919191
0003000100010202060500050090919191919191

image image:meadow
position 3 4 1 *
sprite @13,5 sprite:jigpiece (u32)0
