0400040606050600020405010105020300040106
0500020206020301030001050500060400060005
0005010305020603060506010505050104030102
0602000001000404010102030404010604050402
0305000400010101000105060603000400050404
0504050305040504010006060003060606010203
0604000206000602060602010600030005010503
0605030602000301020005060104010000020402
0201020100040003050602000103030402040500
0400040206060502010100040100050306030204
0504000603060405030201050401040006050205
0203060002040300000600010403040006010506

image image:desert
position 3 5 1 *
