a1a1a1a1a1a1a184919191919191919191919191
03040205020605a0a1a1a1a18491919191919191
060002060102050106010603a0a1849191919191
0605000301060204060000040604a08491919191
040001000202000404040204000200a084919191
0103262727272806020202030206000290919191
0304363737373801050406060406030690919191
0200363737373805000001040102058094919191
0206464714474805000205050404039091919191
5757575787575768010405050406809491919191
0506000606040075040302010080949191919191
0003000100010675010500050090919191919191

image image:botire
position 3 4 1 *
sprite @13,5 sprite:jigpiece (u32)0
debugmsg "botire\u0020ne"
