0000000000000000000000000000000000000630
0000000000000000000000000000000000000430
0000000000000000000000000000000000000030
0000000303030500000000000000000000000530
0000000020220400000000000000000000020130
0000000340420300000000000000000000002034
0000000400030200000000000000000004063025
0000000000000000000000000000000000203435
0000000000000000000000000000000004303531
0000000000000000000000000000000602303531
0000000000000000000000000000000420343535
0000000000000000000000000000000530313135

image image:meadow
position 3 0 10 *
sprite @10,6 sprite:jigpiece (u32)0
sprite @15,4 sprite:treasure (u8:itemid)bugspray (u8:quantity)40 (u16:fld)0
