9191919183a20206303125313125313535352531
9191919192000300404141414141414141414141
9191919192050003020004000602060206030606
9191919192202122064305020200000000030404
91919183a2303133220301050601202201010304
9191919220342525320000440604303200440502
919183a240242341420600010502303201000305
9183a20406404206040202000520343204060104
9192054503040400000320212134234200054405
83a2060204014403202134313531320001010300
9203430600030406404141414141420306430004
9202000244050001000200060005060405010303

image image:meadow
position 4 5 1 *
sprite @10,6 sprite:jigpiece (u32)0
