83a1a1a1a1a20206303125313125313535352531
9220212204020300404141414141414141414141
9230234202050003020004000602060206030606
9240420401202122064305020200000000030404
9201000006303133220301050601202201010304
9200202204404124320000440604303200440502
9200404203000640420600010502303201000305
9200010000430001040202000520343204060104
9204054403060002000320212134234200054405
9206060204014403202134313531320001010300
9206450600030406404141414141420306430004
9202000244050001000200060005060405010303

image image:meadow
position 4 5 1 *
sprite @10,6 sprite:jigpiece (u32)0
