0300010204010301000001010405020204040106
0305050202000404030000030302040102040001
0203040200060205030502010403030502050603
0300020301020400010006040401020206030206
0602060601000600030405060503030205020405
0406020606010005040203020100020104050106
0605030001010106030105050400020005020300
0405000405000203020602030303030000030105
0303040005050506000102030502050002050204
0205000305030606020204020604010003010206
0405010500000402020400060601010500010301
0402060404010101010302030402030406040303

image image:meadow
position 4 5 1 *
