0000000000000000000000000000000430313535
0000000000000000000000000000000330353131
0000000302060000000000000000000630253135
0000000445050000000000000000020630313525
0000000302020000000105000000062034353131
0000000000000000034500000004033035353531
0000000000010605020005000003203431252531
0000000000054501000000000305302535253535
0000000000010400000000000520342525352525
0000000000000000000000000430313535313535
0000000000000000000000000230353125353125
0000000000000000000000000530252535313535

image image:meadow
position 3 1 10 *
sprite @7,4 sprite:jigpiece (u32)0
