83a1a1a1a18491919191919183a1a1a1a1a18491
9205040100a0a1a1a1a184919202010602009091
9205030306020503020190919205040206069091
92000645010303010500a0849205034500009091
9382020302050005060002909200020305009091
9192050005450300000201909203060201049091
9192020605020600060404909381818181819491
9193820300010043020604a08491919191919191
9191920600000403050205059091919191919191
9191920200060606050343049091919191919191
9191938181818182040106049091919191919191
9191919191919193818181819491919191919191

image image:meadow
position 3 6 1 *
sprite @11,6 sprite:jigpiece (u32)0
