2525253532050406000490919191919191919191
3135353132000302000690919191919191919191
4141414142030604050090919191919191919191
000202030006030006049083a1a1a1a1a1a18491
0500020201000104040090920003020000039091
0003000502020201040290920601020206069091
0305040406040002020190920500050004009091
0503040504000344010490920405430505049091
0604000002060101060090920105020304019091
0102000001040602050090938181818181819491
8181818181818181818194919191919191919191
9191919191919191919191919191919191919191

image image:meadow
position 7 7 1 *
sprite @15,5 sprite:jigpiece (u32)0
sprite @8,8 sprite:goat (u32)0
