9192030602303135313525353535253535353531
a1a2060301404141243125253131313135312535
0005050006060004404141414141414141414141
0503060206030205060600030504010001000006
0604000501010606010501050304040601010104
4502000406040104010001060304060505030601
0100020503060605000201000002060406010002
4502020003030003010405000201050300040003
0302000605020403050203010604020000000200
4306010203060405030105050300060606050202
0100020206040103050406020305060003040402
2206000401000600040602030602040204030005

image image:meadow
position -1 1 1 *
song song:toil_and_trouble
sprite @11,6 sprite:jigpiece (u32)0
