2b2b2c000000000000003a1e2b2b1d3b3b3b3b3b
2b2b2c00000000000000003a3b3b3c0000000010
3b3b3c0000000000000000000000000000000020
1617000000000000000000000000000000001024
2628170000000000000000000000000000102421
2626270000000000000000000000000000202121
2626270000000000000000000000000010242121
2626281700000000000000000000000020212121
2626262700000000000000000000001024212121
2626262700000000000000000010112421212121
2626262700000000000000001024212121212121
2626262700000000000010112421212121212121

image image:meadow
position -1 -1 1 *
