0000000000000000000000000130353125252525
0000000000000000000000000430313535312525
0000000000000000000000000430352535252525
0000000000000000000000000330253131353535
0000000000000000000000000630253125312535
0000000000000000000000000430253535313125
0000000000000000000003050130253535252535
0000000000000000000005440030353535312525
0000000000000000040006430330253135313531
0000000000000000004445430330253135353535
0400030305030200060106030530353135253535
2121212121212121212121212134353531313135

image image:meadow
position 3 3 10 *
sprite @12,10 sprite:jigpiece (u32)0
