a1a1a1a18483a1a1a1a1a1a1a1a1a1a184919191
00202122909200050306000605040000a0849191
0440414290920203030501450002010301a08491
020402049092030104060404050106010402a0a1
0506000690938204000502020400060400030200
0500040690919203060301000205000105010302
00060300a0849204020406000002030603010506
0600000600909382040000060005060305020301
0203000604909192020106050306000506010506
0203000002a08492050300000104000606030600
0300040202039092020401000504000003050205
0305000205029092050301000300020205040306

image image:meadow
position 1 6 1 *
sprite @8,4 sprite:jigpiece (u32)0
