a1a1a1a1849191919183a1a1a1a1a1a184919191
21212122a0a1849183a2060605040000a0849191
414124332122a0a1a20106450002010301a08491
040030353533220104010404050106010402a0a1
0504404124253204000502020400060400030200
0506040530313204060101000300020600050004
0006030640243321220600054302440243064404
0600000600303135332200060106010300030000
0203000600303125353204034401450043014405
0203000001402425234200050000020201010005
0300040205043031320306024303440445034302
0305000205063031320201020006050206050604

image image:mountains
position 1 6 1 *
sprite @8,4 sprite:jigpiece (u32)0
rspriteres rsprite:southjungle
