0000000000000000000000000000000000000000
0000000000000000000000000000000000000000
0000000000000000000000000000000000000000
0000000000000000000000000000000000000000
0000000000000000000000000000000000000000
0000000000000000000000000000000000000000
0000000000000000000000000000000000000000
0000000000000000000000000000000000000000
0000000000000004050202010000000000000000
0000000000000004434344020000000000000000
0401060101050502020502040301050000030104
2121212121212121212121212121212121212121

image image:meadow
position 2 3 10 *
sprite @9,10 sprite:jigpiece (u32)0
