0303050100020501000404000603000290919191
01040505050005050600020305030500a0849191
0305000201060000030506030103060300909191
0005020204030406060300040103020001a08491
000203040603000401000101000603000402a084
0100040603060501000602050105050005060690
0304040604030405020605040006060300020590
0506020506020205000506030000010105020590
0601040201020002000604450402050504060690
0200060301060005050201030001050100060490
0500030604030306030404000501050501018094
8181818181818181818181818181818181819491

image image:meadow
position 1 5 1 *
sprite @14,4 sprite:jigpiece (u32)0
