0303050100020501000404000603000290919191
01040505050005050600020305030500a0849191
0305000201060000030506030103060300909191
0005020204030406010300040103020001a08491
000203040605434405020101000603000402a084
0100040603060045440203000505050005060690
0304040604030401004545000406060300020590
0506020506020205020044450500010105020590
0601040201020002000205430602050504060690
0200060301060005050201030001050100060490
0103000503060500060502020600040100018094
0602000002050604020100040106000080819491

image image:meadow
position 1 5 1 *
sprite @14,4 sprite:jigpiece (u32)0
