919183a201020401030506750501030104060400
9191920505020000050100752627272728040102
9183a20500030205030206753637373738040403
9192050605000001010602753637373738060103
9192060603040301050206754647144748060404
9192051603000100000006865757875757575757
9192060103050400010204020603050606030004
9192000003040006010006030605010401020500
9193818200020502050302000304020402000104
9191919382000300060101020004808181820505
9191919193818182020501808181949191938181
9191919191919193818181949191919191919191

image image:botire
position 2 5 1 *
door @14,4 map:116 @9,9 0x0000
switchable @3,5 (u16:fld)barrelhat3
barrelhat @3,5
