0206050504000302060004a08491919191919191
060203010204040500060401a0a1849191919191
0601000010020601011101060100909191919191
0004030304020003000500010200a08491919191
060404030405010104010606040206a084919191
0100100302040006060001021204000390919191
05020201010306040304060503050505a0849191
0105000006060501010102110502030006909191
0404050002100400040504060502060606a08491
050200050200040402030201050105040002a084
0500050001040204000202060603000102020190
0506020402010401020605040606030306010290

image image:meadow
position 4 -1 1 *
sprite @8,5 sprite:jigpiece (u32)0
song song:nearer_the_sky
