3201000000000000000000000000000000000000
3203000000000000000000000000000000000000
3205000000000000000000000000000000000000
3203000000000000000000000000000000000000
3201000000000000000000000000000000000000
3200000000000000000000000000000000000000
3202010200000000000000000000000000000000
3200440100000000000000000000000000000000
3200440106060000000000000000000000000000
3201454444040000000000000000000000000000
3200020105010004020404000405010101040602
3321212121212121212121212121212121212121

image image:meadow
position -2 3 10 *
sprite @1,10 sprite:jigpiece (u32)0
