2523414205069091919191919191919191919191
4142060006019091919191919191919191919191
050002000104a0a1849191919191919191919191
0300030401040206a08491919191919191919191
030413010206030602a084919191919191919191
0206000402000304060490919191919191919191
04040604050113050505a0849191919191919191
0602010500000003030001909191919191919191
0504010400060612050000909191919191919191
0103100003030004000605909191919191919191
0203030005020202020001909191919191919191
0504040004030505020101909191919191919191

image image:meadow
position 4 -2 1 *
song song:nearer_the_sky
sprite @9,5 sprite:jigpiece (u32)0
