0004020605060203040105000406060306000303
0003020202010004060003000603000203040404
0006000402010300020101030006020600010003
0302010305000003010304040300000202030604
0503000005030245064500060302050503050105
0005000501004506430244040100060505020303
0301000003040244064505050405040405030504
0203000204030200000003060400020306010301
0602040100030504050304030404050401050404
0100000305020001010003030000040600040601
0600030606000303040000010206010405060201
0100030300020301010604050203060102040400

image image:meadow
position 1 4 1 *
sprite @13,5 sprite:jigpiece (u32)0
