0500030006020001020400040105000506060504
0402010104030003060603010503060106020602
0402040306010205020503010305000404050000
0502060202050200010205040005050004000205
0601020101040102000406064504030504010602
0606010500010345050145444504010001030200
0402060306060243434506060305010300030000
0600000202060202000603000604030101000301
0100010401040000010102000503010101020103
8204030102040305060002040305020500010006
9381820000020401040000030601022021212121
9191938220212121212121212121213425253131

image image:meadow
position 5 4 1 *
sprite @9,3 sprite:jigpiece (u32)0
