7171717154616161616161537172020506060530
0201010070717171545371720002000106030130
0402040204050101707206000005000404042034
0502060202050201060100000301050004043031
0601b0b1b2b3b403000000000006030504033025
0606c0c1b5c3c402000000000002010001013025
0402d0d1d2d3d402000000000000010300033025
0600000202060601000501000604030001203431
0005010401040000010102000503020420343531
0203000602040305060002040604002034252525
0002060300020401040000030420213431352535
2121212121212121212121212134312525253131

image image:battlefield
position 5 4 1 *
door @4,6 map:118 @9,8 0x0000
