0303030600050104050500000500010005004024
0004050606040102030401040601050006060540
0405020101000202040400000504010604050204
0005060206060403060006040500000504000405
0403060100012022040320220200000301040206
0104010204003033212134320206040000060200
0602000000033035313131320200020606060305
0006060201203425353135332203040101050005
0405000001303525353525313321220500000400
0020220204302531353535313531332122040305
2134320520343531353135353131353133220206
2535320230313135252535252531353131332121

image image:meadow
position 6 4 1 *
sprite @9,3 sprite:jigpiece (u32)0
