0000000000000000000000000000000000434343
0000000000000000000000000000000000434343
0000000000000000000000000000000000434343
0000000000000000000000000000000000000000
0000000000000043000000000000000000000000
0000000000000043000000000000000000000000
0000000000000043434300000000000000000000
0000000000000000000000000000000000000000
0000000000000000000000000000000000000000
0000000000000000000000000000000000000000
0000000000000000000000000000000000000043
0000000000000000000000000000000000004343

image image:meadow
position 6 3 1 *
