0201030202000405000100010401030405020290
0505000501030503050505010604040103010190
0000000100050306060404040304000203018094
0402020602020503040305050105060006039091
0505030102020505010500060300020205809491
0000040401000101050501020302060402909191
0004060305010006030101040600020404909191
0302020500000305030504030603030580949191
8181818206050103020606040301018094919191
9191919381818181818181818181819491919191
9191919191919191919191919191919191919191
9191919191919191919191919191919191919191

image image:meadow
position 0 3 1 *
song song:toil_and_trouble
sprite @9,6 sprite:jigpiece (u32)0
