3525252535320000010300060004303135313131
3125352535320004020100000000303131313125
4141414141420402050003010601404141414141
0605020100030303040400030006000005040001
0402020605000605202205202200050402050603
0306000016030100404200404201000101020506
0305000502010304060100010300060506050304
0205020300040201202205202203010200050302
0005050600020103404200404202020506060602
0605030303000300020202030102020105020405
8181818181818181818181818182048081818181
9191919191919191919191919192039091919191

image image:meadow
position 6 7 1 *
sprite @10,6 sprite:jigpiece (u32)0
door @4,5 map:102 @4,5 0x0000
