2532014405040604030304606206000306060404
2532010405430204010605606204020406050104
3532060044060102050101606206030002060006
2533220201044306060606606351515151515151
2525320445000102000106605371717171717171
3135320005024302000204606201040406030304
2525320044030502030004606205020401010006
3535320100044405430603606203004305430145
2525332205010403060601606206000006060406
2525313202000643044305606206430144034505
2525313203030401010105606203010602050102
3125313201000001060203606204060005008081

image image:meadow
position 1 -2 1 *
sprite @10,5 sprite:jigpiece (u32)0
