0106030300000605040400010504050300040400
0505000601050600060000010606060404000605
0602000003000502000201000405030001050006
0400000103010506000503060206020001010504
0404030503040201454443000006000603060602
0005030406020400430204010003000402050503
0001060602030202430301060602020405050000
0604000600040302050205060202010601000002
0000040205010605000603020603020002000304
0405000200020101050504060204050001010402
0503060300030200030402030602060306020406
0503000204000200020004030606010603030403

image image:meadow
position 5 2 1 *
sprite @10,6 sprite:jigpiece (u32)0
