3131234141414141414141414141414141414141
2525320006020406000100060100050505000104
2535320644454402000000000000000000000000
3535320543000203000000000000000000000000
2535320544000000000000000000000000000000
2525320506020000000000000000000000000000
3531320200000000000000000000000000000406
2535320000000000000000000000000000000320
2525320100000000000000000000000006002034
2531320200000000000001030603060620213431
2531320000000000000405202121212134252535
2531320500000000042021343525253131253525

image image:meadow
position -2 -3 10 *
