3131313535313131252535312531253123420300
3535353125313131353535252535252342050003
3531313125234141243125313535234205060606
3525253523420004303523414141420605060305
2535312342050005302342000201020100000205
3125313204012021343206000602010304000406
3535253205044041414205000506020100040502
2535253206020601010003030000060005000101
3531353322020204020501040204020205010002
2525353133212121212122040103040406202121
3531252535252535312533212121212121343125
3525352525253135312531353131353531352531

image image:tundra
position 6 2 1 *
sprite @7,4 sprite:jigpiece (u32)0
