0130253125353525320300014024252531352525
2134352525252523420200040640243125313131
2531313125252342060500000003402431352525
4141414141414205000000000001054024353525
0004030300000000000000000000060440243535
0604040200000000000000000000000001302535
2121220602040100000000000000000000303535
3525332121212206050000000000000003402435
3531253135353321220504000000000003023031
3131253131353535332203040400000000033035
3535353525352531313321220300000000003031
2531313535252531313125320400000000053025

image image:meadow
position -1 -1 10 *
