3131313535313131252535312531253131252531
3535353125313131353535252535253535253525
4141414141414141243125313535353131312531
0003060001000504303523414141414141414141
0205020402010105302342000201060302060306
0305060501022021343206000602010304000406
0001060206044041414205000506020100040502
0101020603060601010003030000060005000101
0403060600040501060204010204020205010002
0500030503050004010303050404030401202121
0400000502060405000200040600050102303125
0204030501020302000300020400030101302531

image image:meadow
position 6 2 1 *
sprite @7,4 sprite:jigpiece (u32)0
