0406000605010006000202000005040406020340
0301010505040401000406040303050400010202
0300060501060400000105060000000001010102
0000050605010006000500050103000504050505
0104050602020503040006030404000300030504
0301050103040405000200030401030601020605
0000020606042021220201064502050002010100
0302000102044041424444444403000103030500
0602040403000501000200040300010605010302
0406040601030201030603060304050404000200
0403000204020606000102000303010204030504
0403000405040005060602000200000105040303

image image:meadow
position 6 1 1 *
sprite @9,3 sprite:jigpiece (u32)0
