0406063025320606053032020006303135313531
0301043031320301054042050300302525234141
0300013035320100030402060204302523420302
0000023035320106000405000320342342050505
0102203431320502040645050630313200040504
0303303131332202000100060630353201000605
0005303131353321220201062034253200054401
0105303535313125332121213431353322050505
0220342535312525252535313535353132040600
0440243125252535352535313535252532050301
8182404124313125313135313525253133220301
9193818230352525353525253125253135320401

image image:tundra
position 6 1 1 *
sprite @9,3 sprite:jigpiece (u32)0
