3535234141414141414141420000000000043025
2341420500010303010001030300000000003025
4204020303060300030106000000000000033025
0601032021212121212122050305040200013025
0000013031253525352533212121220100044041
0601024041412425352523414141420600040001
2206010304064024352342020203020000050005
3203000500060540414205050000000203032021
3321220306000404060400060605012021213431
3525332203010202000004002021213435353131
3535253321212204000000203431252531253131
3535352525253322010005303535253135353535

image image:meadow
position -1 0 10 *
