0406000605010006000202000005040406020340
0301010505040401000406040303050400010202
0300060501060400000105060000000001010102
0000050605010006000500050103000504050505
0104050602020503040006030404000300030504
0301050103040405000200030205000006020605
0004030202012021220201062021212200020603
0600202121213425332121213431353321212205
2121342535312525252535313535353131313321
3135253125252535352535313535252525252535
3525352531353135312525253535313135352525
3131313135312531313135252525352531253525

image image:tundra
position 6 1 1 *
sprite @9,3 sprite:jigpiece (u32)0
