0103020205010500060300060000020006040105
0002020603430602030301030602010204010200
0503430500010000030100044506000206040306
0602000102020001430602030506060102010106
0500044400040606030003030300040543030402
0105050603034306040100050606060005040203
0406450100040205000401044403040601030502
0105030300040206060003040500010006014302
0303000500000503004500000304030603060206
0304202121220001060401050520212122030503
2121342535332121212121212134352342010680
4747474747474747474747474747474839818194

image image:tundra
position 5 1 1 *
sprite @7,7 sprite:jigpiece (u32)0
rspriteres rsprite:tundra
