9191919191919191919191919191919191919191
9191919191919191919191919191919191919191
9191919183a1a1a1a1a1a1a1a1a1a1a1a1a1a1a1
9191919192040604010405060105020303020000
9191919192010605010202050301030405060202
9191919192040301060506010103000202030602
9191919192020004040404030401040600020406
9191919192050604020502060304000103050005
9191919192020201050505000206060102020502
9191919192060402050001060003040605040205
9191919192060000040400030400030205050600
9191919192060505000500020602000101050405

image image:meadow
position -3 -1 1 *
sprite @11,6 sprite:jigpiece (u32)0
song song:snowglobe
