0103020201000400060300060000020006040105
0002050405060102030301000001010204010200
0500000501010100010000000001000206040306
0604060402020005010602020102060000040106
0500060106020400010103030300040104000402
0105050602020201040100010603060006040203
0406060600000601000401030606040601060002
0104020000040206030305020501010001030605
0303000500000503000302000304030605202121
0304202121220001050301050520212121342341
2121342535332121212121212134352341414280
4747474747474747474747474747474880818194

image image:tundra
position 5 1 1 *
sprite @7,7 sprite:jigpiece (u32)0
