9191919192020402000502040503060504000301
9191919192000506060000040403060000050402
9191919192040006010402040403020506000605
9191919192010004000604040304060201060206
9191919192010004030500050506030500010506
9191919192040300010001050104010101000102
1515151515000206000103050302000304000206
9191919192010303010601000403040101050502
9191919192050503000102000602010200050401
9191919192060603000500020105010201000102
9191919192040301030006010203020206060202
9191919193811581818181818181818181818181

image image:meadow
position -3 0 1 *
sprite @6,9 sprite:jigpiece (u32)0
song song:snowglobe
