2525252531353125313535352531252531252525
3531313125353535312535313135313131313135
3531253135313125312531253135252531253535
3531352525252535312531253125352525252525
4141412435353135313125352525313525312531
0101044041414124313135253135312531234141
0004010203040340414141414141414141420603
0502000601060500030200010002000502020504
0206000201000605030602020105010202010500
0201000605020201060106020201060506050300
2200060206040401030606050300020605000200
3202030500000401010600060504060102030600

image image:tundra
position 8 0 1 *
sprite @11,10 sprite:jigpiece (u32)0
