3125352531252342060001404141412431353525
2535312525313205040001040506064041243135
3125313523414204000000000000030106404141
3535312342060000000000000000000000000403
3135234206020000000000000000000000000000
3523420602000000000000000000000000000000
4142060300000000000000000000000306060604
0504020000000000000000000506040080818181
0000000000000000000005020080818194919191
0000000000000000030204808194919191919191
0000000000000000018081949191919191919191
0000000000000003809491919191919191919191

image image:meadow
position -1 2 10 *
sprite @9,5 sprite:jigpiece (u32)0
