2535312535353531312531329092303525253531
3525253531253131313535329092303131353135
4141414141412425352531329092302341414141
0502050301024041414141429092404204010602
0000000000040105000500049092010500000000
0000000000000000000000059092020000000000
0001030000000000000000050000060000000000
8182030200040600000000009092020000000000
9193818181820006030000039092050401010306
9191919191938181818203009092000580818181
9191919191919191919381819493818194919191
9191919191919191919191919191919191919191

image image:meadow
position 0 2 10 *
sprite @5,3 sprite:jigpiece (u32)0
