2531312525352535252531313135353125253131
2525352535253135313531253125352531312531
2531253531312525312535313125353535352525
3135313531353135312531312525313531313135
2525353525253535312525253131353131352535
4141414141412425313131313525313525252531
0002000004014041242531313525313531353525
0406000000060601404124352531253525253125
0504020401000404020430313535352525252525
0204000302010605040440243535352535313525
0202030000040300020206303525352535253131
0603010506000602030600302531253535253135

image image:tundra
position 9 0 1 *
sprite @9,8 sprite:jigpiece (u32)0
