0000060405050200030404000003060401000230
0005050102030501050102060000060501060630
0403030003434506020443450402010004000330
0204020543064500030004044505010004020530
0104020200454501020602430002020100050030
0400010000044501060545050303040205040030
0000040003044401430245454402000304010130
0003040403020601450000050000060606000630
0000010604020401060603040502000100050430
0601020603040602000300050206020100020030
0600050400040204000000040500000001020630
0602020304060302010001000400000300020630

image image:meadow
position 9 2 1 *
sprite @16,6 sprite:jigpiece (u32)0
