9191919191919191919191919191919191919191
83a1a1a1a1a1a1a1a1a1a1a1a1a1a1a1a1a1a1a1
9205030006010206040206040103000500060405
9202000406000503030600030502000104020002
9206060602000002000104020005010300050501
9201050604050302030005030303050205000605
9204050000060300000401010401030200010603
9200000606040405000601001506040104030202
9201010505040203060005060600050301000601
9202050305040104040205020201000202050302
9200040506060203010402050602000000010080
9203050505060004000500040201020305058094

image image:meadow
position -5 -2 1 *
sprite @6,4 sprite:jigpiece (u32)0
song song:toil_and_trouble
root @11,8 (u16:fld)root4
root @11,11 (u16:fld)root4
root @11,10 (u16:fld)root4
root @11,9 (u16:fld)root4
sprite @11,7 sprite:treasure (u8:itemid)gold (u8:quantity)10 (u16:fld)root4
