9191919205010506020100060500053025313531
9191919201010402060103010100013035312525
9191919201010001010405040006014041414141
9191919206060100030604010303020003010305
9191919202030105060406030106060404060004
9191919204040102060303020201040600060500
9191919200040105000000040305020201010500
9191919203060200020002000006000004010304
9191919200040101050403020500020005000005
9191919202010401050501050300020605000001
9191919381818181818181818181818181818181
9191919191919191919191919191919191919191

image image:meadow
position 5 7 1 *
