9191919205010506020100060500053025313531
9191919201010402060103010100013035312525
9191919201010001010405040006014041414141
9191919206060100030604050104020003010305
9191919202030105060406061504060404060004
9191919204040102060303000406040600060500
9191919200040105000000040305020201010500
9191919203060200020002000006000004010304
9191919200040101050403020500020005000005
9191919202010401050501050300020605000001
9191919381818181818181818181818181818181
9191919191919191919191919191919191919191

image image:meadow
position 5 7 1 *
sprite @8,6 sprite:jigpiece (u32)0
sprite @5,8 sprite:soldier (u32)0
root @13,4 (u16:fld)root6
root @19,4 (u16:fld)root6
root @18,4 (u16:fld)root6
root @17,4 (u16:fld)root6
root @16,4 (u16:fld)root6
root @15,4 (u16:fld)root6
root @14,4 (u16:fld)root6
