0603010205010602040106020502020004050304
0505000101020002020402030603050201020501
0103040504040300040301050602050000000306
0203000006000500030606050000030205060102
8181818200020605020204040101040303020604
9191919205050303060200000203060003040104
9191919205040506050404060305060306050606
9191919205010300010302040205020301030204
9191919381818181818181818181818181818181
9191919191919191919191919191919191919191
9191919191919191919191919191919191919191
9191919191919191919191919191919191919191

image image:meadow
position -1 3 1 *
song song:toil_and_trouble
sprite @10,4 sprite:jigpiece (u32)0
rsprite (u16)0 sprite:koala (u32)0
