920300030401050601010605040002010301a084
92010604020400060502000500010606030503a0
9201040400000403030300000101060302030006
9206060002040501020305030103020206060306
9201020101020500000502030100030401060600
9200000003050005000006000202020106050604
9201010603020002020004060403060004000304
9201060506060101000404060106060503040301
9202060600020402020400010506020300000005
9206050402020201030205040403030001060000
9204050602020604030502040306030106010180
9202050504010301000102060402060402038094

image image:meadow
position -5 -1 1 *
sprite @8,4 sprite:jigpiece (u32)0
song song:toil_and_trouble
