3525313531353135320503402431353531313125
3525313535253123420505044041242535253531
4141414141414142040000060303404124253135
0003060401030400010000000006000240414124
0103030000000000000000000000000000020040
2122020300000000000001000106000500000102
3533220603000000000006202121220504020600
3525332206000000010520342531332121220200
3535253205000004002034353131353531332121
2531253201000102203431253535252531253531
3131353204000320342531252525313135253531
3135313205000130312535253125253135252531

image image:meadow
position 1 0 10 *
sprite @7,5 sprite:jigpiece (u32)0
