0104010305050406043025252525353531353531
0502000100040500054024312525312531253535
0603050500060301030430352535253531253131
0100020104050003050130352535312525313525
0000040101020503020230312535313125352535
0401060000030304020230353135313135313125
0405050305060606042034253525352531353525
0605000605020001003031352535353135253125
0006000003000205023025352531353135312531
0102040200060103003031312531253131252531
0503040006060600203435253135252535313135
0002010003060206303125313531313131313135

image image:meadow
position 9 4 1 *
sprite @4,5 sprite:jigpiece (u32)0
