3525352535313135320105303525353131253535
2535253125253525320601303135313125352525
3525352531352525320201404141414141242535
3131312535312525320300030600030102302535
3531253125253131320500202121212206303531
3535253135313535320504303135253206303535
2531352535353535320305302525353205303125
4141414141414141420501404141414205404141
0204020504050202020402050202050304030403
0404050105000601050400030305020303000506
2121212121212121220305202121212121212121
3535313525252525320403303525352531312535

image image:meadow
position 1 -1 10 *
sprite @16,3 sprite:jigpiece (u32)0
