0305010000010002000300050602010105000530
0004040004040205040402050601020206040530
0102050100010002020201060605040000020630
0001050302434301010103440001010501000130
0003040445044502000143030306030601000030
0000000306444500020045440204030400040230
0206050300004502040243034305000504040030
0503000405004401440600450205020002050230
0604040202020100450506020502060103030430
0200060105010403040303040201040000000030
0500060602050601020506060602000101000130
0005000405000506050203000402010400060630

image image:meadow
position 9 6 1 *
sprite @8,4 sprite:jigpiece (u32)0
