9191919191919191919191919191919191919191
9191919191919191919191919191919191919191
9191919191919191919191919191919191919191
a1a1a18491919191919191919191919183a1a1a1
060000a0a1a184919191919183a1a1a1a2040501
000006030503a0a1a1a1a1a1a200060202000000
0104000000060605030602050202000000000106
2200030400000000000000000000000005000320
3321220601030000000000000000060400202134
3131332122010102030000000100002021343535
3135353133212122050205060120213431313131
2535253131353133220004202134313535253135

image image:meadow
position 1 -2 10 *
sprite @5,5 sprite:jigpiece (u32)0
