0305010000010002000300003031353125252535
0004040004040205040402033025352525353125
0102050100040002020200043031353131253535
0001050002060200010105203425313135352535
0003040502010003000120343131253131353135
0000000104040406020330313525313131313131
0206050300000401000030353531313525253535
0503000400040302050030313531312531253535
0604040202020401060230313525252531353531
0200060105000603000130253135313531313135
0500060602050601032034353131253131312535
0005000405000506203435353131313125353131

image image:meadow
position 9 6 1 *
sprite @8,4 sprite:jigpiece (u32)0
