9191919191919191919191919191919191919191
9191919191919191919191919191919191919191
9191919191919191919191919191919191919191
9191919191919191919191919191919191919191
9191919191919191919191919191919191919191
9191919191919191919191919191919191919191
919191919183a1a1a1a1a1a1a1a1a1a184919191
a1a1a1a1a1a202050000060504000204a0a1a1a1
0004000406030501050505060401010002030204
0203060406060205010105050001020003060503
0201010302050200000505060003060305010606
0301060100050203060006020002060302010306

image image:desert
position -4 4 1 *
song song:blood_for_silver
sprite @10,8 sprite:jigpiece (u32)0
rsprite (u16)0 sprite:koala (u8)100 (u24)0
