0405909191919191919191919191919191919191
05019083a1a18491919191919191919191919191
0305909200009091919191919191919191919191
0600909203029091919191919191919191919191
0006909381819491919191919191919191919191
0504909191919183a1a1a1a1a184919191919191
0200a0a1a1a1a1a20606030502a0a1a184919191
06040106040605000102020105050102a0a1a1a1
0105000101040302010002050302020306000104
0604030401060306000501060602040006060504
0504030000050200010401040101000503060204
0205000101040505050402000505010204030001

image image:desert
position -5 4 1 *
sprite @10,7 sprite:jigpiece (u32)0
song song:blood_for_silver
rsprite (u16)0 sprite:koala (u8)100 (u24)0
