3135313535353525252535253532050000000000
3535252531353535313131352342020000000000
2535252535312531352535234204030000000000
3131252535253131312523420005000003000400
2531313531353131252342040300000004430200
2525253531252531234203010104000401030200
2525353125253123420406040420220205000000
4141414141414142000000022034332203000000
0501040101000206030000013035353204000000
0404060006040102000000024041414204000000
2121212121212200020000010601050003000000
3531353525353322030000000000000000000000

image image:meadow
position 2 -1 10 *
sprite @14,4 sprite:jigpiece (u32)0
