2525353131352342040000000000000000000000
3131253531253201050000000000000000000000
2525252531234203000206000500000000000000
3125313123420202000345050443000000000000
4141414142040404050202060106060000060500
0200010105030345010000004500000001440500
0000000000000205040200040400000501030000
0601010300000006430300040506450200000000
2121220501000005040500064306000000000000
2535332204060000010605020605000000000000
2525313322060000024506000000000000000000
2535353132030000040506000000000000000000

image image:meadow
position 2 0 10 *
