0000000000000000000000000000000000000043
0000000000000000000000000000000000000043
0000000000434300000000434300000000000043
0000000043004300000043004300000000000043
0000000000434300000000434300000000000043
0000000000004300000000004300000000000043
0000000000004300430000004300000000000043
0000000000000000430000000000000000000043
0000000000000000000000000000000000000043
0000000000000000000000000000000000000043
0000000000000000000000000000000000000043
4343434343434343434343434343434343434343

image image:meadow
position 9 9 1 *
