0505030206060600000300060013121110121312
0002030406040603000503010313111311131210
0405030602010004010204001011111010121212
0201020206040400060205121210121012121210
0002030502040401031210111112101013101212
0005040004060005111212111212111213101010
0504000401121310101213121313101110111312
1311101010131210121211121110111113131211
1112121211131013111110111011131112111211
1013111113101113111110111010121013131013
1312131311121212101112101111101313131112
1010111211131113131312111010121012111013

image image:desert
position 9 9 1 *
sprite @4,2 sprite:jigpiece (u32)0
