9191919191919191919191919191919191919191
83a1a1a184919191919191919191919191919191
a206050490919191919191919191919191919191
04050304a0849191919191919191919191919191
0502040600909191919191919191919191919191
0606010106909191919191919191919191919191
0404000305909191919183a1a184919191919191
0106020204151515151515010415151515151515
0601000180949191919192000090919191919191
0302058094919191919193818194919191919191
0501069091919191919191919191919191919191
0504809491919191919191919191919191919191

image image:meadow
position -5 3 1 *
song song:blood_for_silver
sprite @3,4 sprite:jigpiece (u32)0
