3125252342010005303531312531252535253135
2523414200000400402425253135312535234141
4142000003000300014041412435253123420504
0002000001010301040001014041414142030304
0500060503000104040601060600020604000005
0005020302060305020106010106020204000300
0602000000000600040001010202030406040504
0300000602060504020501000101010005060502
0302050606020102000600030105040100060006
2205000303030500010600040203040203020102
3203030504000504000205010600020105060100
3203020103060602000204020002010203000506

image image:meadow
position 8 2 1 *
sprite @2,2 sprite:jigpiece (u32)0
