9191919191919191919191919191919191919191
9191919191919191919191919191919191919191
a1a1a1a1a1849191919191919183a1a1a1a1a1a1
0505040203a0a1a1a1a1a1a1a1a2000602020506
0001050200060106060503060105030006020504
0200010202050504010502040606000304050603
0602020601020603060605000105060401010203
0005030200000206000402030401040202040103
0403010602000601030305010000040403000401
0604060300010604060206030604000006020401
0403060500000005050301000601040003010501
0002000105000200020003020500050601010503

image image:desert
position -6 3 1 *
