2531352535313525234141414204000000000000
3531312341414141420003030102000000000000
4141414206050102010600000000000000000000
0501050501000000040605000000000303050000
0000000000000000004503000000000543050000
0000000000000000000501000000000603000000
0000000000040000000000000000000000000000
0000000443020005000100000000000000000000
0000000106020005440300000004030000000000
0000000000000000020600000004430500000000
0000000000000000000000000001050600000000
0000000000000000000000000000000000000000

image image:meadow
position 2 2 10 *
sprite @11,6 sprite:jigpiece (u32)0
