3203010102020200020400020202020300020203
4206000604050200000303040301040404020001
0202040105030406010006030502040200000500
0300020400030204050501040000060003030502
0303010300050002030006020005040503040505
0202000006060001000005030404030503020505
0601050005050501010104010604030106000004
0305030105020403010205060605030504040600
0001000305040302030301020501060603010505
2200030001020400000000000206030504010000
3202010502000001000401040500000303010006
3200030604040004010000020504020301060100

image image:meadow
position 8 3 1 *
sprite @14,8 sprite:jigpiece (u32)0
