0403030404040601050102000602060102030604
0405020101050201050504030006000304000600
0102050400010004050002050304060403010004
0103010402030306000406050406030600030405
0203020400000603060404060604000100040106
0004000103030002010301060502050005050304
0204000502050101050406020300030401060302
0100040101010501020503030103040606000601
0200040601010104060406040306020006020000
0203000404000003060004000003010302020300
0600030004060602050605050100020206060400
0500020200000002000302010402020204050404

image image:meadow
position -3 5 1 *
