0200050002050604010406050106030605060206
0200050005060300010504050002060404020405
0503060203000203020504000606000004050203
0101000403060101010506050001000404000403
0401050603010002020405010306000001000203
0104020605000402050305010405050004020204
0602020605030104060405000106020606010004
0205020303000006050603060602040306030405
0300020003020602060301030300000203010506
0003000101030502030200030605030005020005
0100010206020501040602030404060505060200
0003040405000605050403000402020200000201

image image:desert
position -4 5 1 *
rsprite (u16)0 sprite:koala (u8)100 (u24)0
