9191919192010300050201030604020502010202
9191919192064402050001010402020400030006
9191919192060206000003030600010104040205
9191919193820501020301020205010406060204
9191919191931581818181818181818181818181
9191919191911591919191919191919191919191
9183a1a1a1a11584919191919191919191919191
91920502030002a0849191919191919191919191
1515040605000305909191919191919191919191
9192000104044301909191919191919191919191
9193818182020006909191919191919191919191
9191919193811581949191919191919191919191

image image:meadow
position -2 3 1 *
song song:toil_and_trouble
sprite @3,8 sprite:jigpiece (u32)0
