91919206040201050500010306020000c9fafbfd
91919202050105000600060306000304b7bffbfa
9183a20504db0002060500020306050203c0edf0
919200020504050501d5b6010200000503b9e5fa
83a2000101040604b0cfc2010105030200c7b4f1
92b0b1b205010403d7b4da03010506010502d9fd
92b9e6ceb205000002b7d20105dd01000403d7df
92c0e5e8cec600040206010601040102060406d7
92c9eae8e2eeb202040404010305011205010300
92d0dfc1f1e7c206030606061204030406020100
9382d0bfebe1c3c6050103010005000106050601
919382b9ede8f5ceb2010406040100020001b0bd

image image:mountains
position 8 5 1 *
sprite @14,4 sprite:jigpiece (u32)0
