0100010206010205010306040206000404050405
0005020204060100030500060004060304050401
0100060600020006060000000206030304060501
0000020606050205040101060603000505020606
0004050002010500050202060503010600010006
0401040203010400050602010602000202010401
0504000002010600040400040606020100010404
0100010403020400050501060003040401020401
0402020605060302060003020001020103050602
0403000100040202060001040401020604030301
0001030503050101040001050406000402030103
0106060200030003040602050000050605010106

image image:meadow
position -6 5 1 *
