0000000000000000000000000000000000000000
0000000000000000000000000000000000000000
0000000000004300000000434343000000000000
0000000000430043000000000043000000000000
0000000000004300000000000043000000000000
0000000000430043000000000043000000000000
0000000000004300004300000043000000000000
0000000000000000004300000000000000000000
0000000000000000000000000000000000000000
0000000000000000000000000000000000000000
0000000000000000000000000000000000000000
0000000000000000000000000000000000000000

image image:meadow
position 8 7 1 *
