920300010405030002060404040500030404a084
92020306060201000501050603000004010005a0
9204000305040504040106060003030403010306
9382030005050205000300000301050300060606
9192030102040004030204050505010104060303
9192040302030503060504060000000303010405
9193820403060203000101040505020600020101
9191938182060504040006020305060505058081
9191919193820000040501030304048081819491
9191919191938181818181818181819491919191
9191919191919191919191919191919191919191
9191919191919191919191919191919191919191

image image:meadow
position -5 2 1 *
sprite @8,3 sprite:jigpiece (u32)0
song song:toil_and_trouble
rsprite (u16)0 sprite:leopard (u8)100 (u24)0
