4400000000000000000000000000000000000000
4400000000000000000000000000000000000000
4400000000000000000000000000000000000000
4400000000004400000000004400000000000000
4400000000440044000000440044000000000000
4400000000440044000000004400000000000000
4400000000440044000000440044000000000000
4400000000004400004400004400000000000000
4400000000000000004400000000000000000000
4400000000000000000000000000000000000000
4400000000000000000000000000000000000000
4400000000000000000000000000000000000000

image image:meadow
position 0 8 1 *
