83a2000003050204030400030301029091919191
a202020205030002030302030000019091919191
040406020100010000010302040100a084919191
0605020004040200000004000305000190919191
0303020206010205060604060303050590919191
0501040001040002010204050404000090919191
05020200060006000601050406060405a0849191
0401050206010302020403040105020402909191
0603010203060501040301030006030406909191
0001040400000205000401030406060005a08491
8204020505000400000502020505020303069091
9382060405010605030603000204050500009091

image image:meadow
position -4 1 1 *
sprite @9,5 sprite:jigpiece (u32)0
song song:toil_and_trouble
