12121313121310101218090909090a9191919191
0204101013101311030505030004909191919191
0406031012110303040301505202a08491919191
000100060206060000060560620502a0a1849191
0104050106050401060003606202040006a0a1a1
0305505151515151515151646352000604030205
0001605371717171717171715463515151520203
0203707205030503000300057071717154635151
0101060302030001040412010105111270717171
0605001302051101040002040501111201000201
0211040503050302000206130000010105030000
0400000103040305000604020602030003000004

image image:desert
position 1 8 1 *
sprite @10,4 sprite:jigpiece (u32)0
