1212131312131010121106020206909191919191
0204101013101311030503030300909191919191
0406031012110303040302050205a08491919191
000100060206060000060002000202a0a1849191
0105040000000003000104050304040006a0a1a1
0302050203040503010503010605030300000205
0004040600040002010006100300000404030104
0201030506020503000101050106030205010106
0100040106050305040304060105050400020000
0203050605020403040300010604010401010400
0202010206000003000200010203030500030000
0106020103040305000600060302030003000004

image image:desert
position 1 8 1 *
sprite @10,4 sprite:jigpiece (u32)0
