ccccdfa7ecab98bebe19090909090a9191919191
02048cbfa868cbcccb8d03060304909191919191
0006018ccb870602040300505200a08491919191
020203010302030503020460620004a0a1849191
0003040404060302000103606205000503a0a1a1
0005505151515151515151646352010105010301
0301605371717171717171715463515151520303
0000707201040005040103007071717154635151
0104010102050403030336040405657b70717171
050604ff040288000401040404008c8d00000200
0111010100010501050306dd0400010103020104
0304060505060105010502000203000106000604

image image:desert
position 1 8 1 *
sprite @10,4 sprite:jigpiece (u32)0
