0000000000000000000000000000000000000000
0000000000000000000000000000000000000000
0000000000000000000000000000000000000000
0000000000444400000000440000000000000000
0000000000000044000044004400000000000000
0000000000004400000000440000000000000000
0000000000440000000044004400000000000000
0000000000444444004444440000000000000000
0000000000000000004400000000000000000000
0000000000000000000000000000000000000000
0000000000000000000000000000000000000000
0000000000000000000000000000000000000000

image image:meadow
position 2 8 1 *
