9191919191919191919191919191919191919191
9191919191919191919191919191919191919191
919191919183a1a1a1a1a1a1a1a1a1a184919191
83a1a1a1a1a204020402000501010005a0a1a1a1
a204010401060605050404040403010300000601
0006000601030001060205010350515151515151
0402010110020150515151515164537171717171
5151515151515164537171717171720405030200
7171717171717171720b0c0c0c0d000605040500
0101040501030201051b1c1c1c1d013604000404
0003061001030604042b2c2c2c2d050206050303
0205020406000303041047474747050505000306

image image:desert
position 2 8 1 *
sprite @6,4 sprite:jigpiece (u32)0
rspriteres rsprite:westdesert
track @7,3 4 4
sprite @10,11 sprite:ticker (u16:fld)zoo3_0 (u16)0
zookeeper @9,8,5,3
sprite @8,9 sprite:zookeeper (u16:fld)zoo3_0 (u16)0
