9191919191919191919191919191919191919191
9191919191919191919191919191919191919191
919191919183a1a1a1a1a1a1a1a1a1a184919191
83a1a1a1a1a204020402000501010005a0a1a1a1
a204010401060605050404040403010300000601
0006000601030001060205010350515151515151
0402010110020150515151515164537171717171
5151515151515164537171717171720405030200
7171717171717171720103060301020605040500
0101040501030201000305000006043604000404
0003061001030604050400050600000206050303
0205020406000303010413060305030505000306

image image:desert
position 2 8 1 *
sprite @6,4 sprite:jigpiece (u32)0
