9191919108090909090a91919191919191919191
91919183a203010105a0a1a18491919191919191
919183a20100051205020300a0a1849191919191
a1a1a20206045052060404010505a0a184919191
04010105040060620503000406040104a0a1a1a1
5151515151516462000602010604040505020406
717171717171717201008a6b0005040606010401
0501020000040505016579770103060003050306
0612020604db0300028e687d0200010200060401
0206000603050300027c7d001102030505050201
0503060412040304040502020103040204050405
0204030501000100040301060000000302050200

image image:desert
position 3 8 1 *
sprite @14,8 sprite:jigpiece (u32)0
