9191919191919191919191919191919191919191
9191919191919191919191919191919191919191
9191919191919191919191919191919191919191
9191919191919191919191919191919191919191
9191919191919191919191919191919191919191
9191919191919191919191919191919191919191
91919191919191919191919183a1a1a1a1a18491
9191919191919191919191919204030402069091
9191919191919191919191919204000102019091
9191919191919191919191919203060243059091
9191919191919191919191919381818181819491
9191919191919191919191919191919191919191

image image:meadow
position -3 3 1 *
sprite @15,8 sprite:jigpiece (u32)0
