9191919108090909090a91919191919191919191
91919183a205010603a0a1a18491919191919191
919183a20101031206000202a0a1849191919191
a1a1a20500005052040601030006a0a184919191
02000502020160620204020201020504a0a1a1a1
5151515151516462030604020605040105000500
7171717171717172060012100206050002020000
0606000601000301061113120405020602040104
0210040205100601021110110002030502000001
0103050305060406021012061104010002010001
0304060312010203030500030400050606000205
0505050002050103000203000100000103060101

image image:desert
position 3 8 1 *
sprite @14,8 sprite:jigpiece (u32)0
