919191919202000605a0a1849191919191919191
91919183a2050106030203a08491919191919191
919183a20100051105000202a0a1849191919191
a1a1a20500030004010601030006a0a184919191
01050601020402040604020201020504a0a1a1a1
0506050005040101010606000505040105000500
0005060104030601050401010406050002020000
0001000305000400060104040105020602040104
0500030205100601060601000601030502000001
0302060406020406020004040602010002010001
0304060601020203050603000300050606000205
0505050500000103000203000100000103060101

image image:desert
position 3 8 1 *
sprite @14,8 sprite:jigpiece (u32)0
