9191919191919191919191919191919191919191
9191919191919191919191919191919191919191
9191919191919191919191919191919191919191
9191919191919191919191919191919191919191
a1a1a1a1a1a1a1a1a184919191919183a1a1a1a1
020103050306040601a08491919183a206010200
02000301020502030506a0849183a20000010403
0400000400020300050400a08492010303060101
0002020500100402030602069092040000010003
0301060301060103000604019092020001040000
0302000304000405000604029092040001020002
0406030006010505020006019092010104050206

image image:desert
position 4 8 1 *
sprite @8,8 sprite:jigpiece (u32)0
