9191919191919115919191919191919191919191
9191919191919115919191919191919191919191
919191919183a115849191919191919191919191
91919183a1a20605a08491919191919191919191
919191920601050603a084919191919191919191
9191919203040600000490919191919191919191
9191919200000606060290919191919191919191
1515151506010105030190919191919191919191
9191919381818181818194919191919191919191
9191919191919191919191919191919191919191
9191919191919191919191919191919191919191
9191919191919191919191919191919191919191

image image:meadow
position -4 3 1 *
sprite @6,5 sprite:jigpiece (u32)0
