9191919191919191919191919191919191919191
9191919191919191919191919191919191919191
9191919191919191919191919191919191919191
9191919191919191919191919191919191919191
a1a1a1a1a1a1a1a1a184919191919183a1a1a1a1
020103050306040601a08491919183a206010200
02000301020502030506a0849183a20000010403
0400000646060300050400a08492030400030500
0002024616130402030602069092061113131310
0301060446010103000604019092031010111112
0302000304000405000604029092051312030600
0406030006010505020006019092021311040206

image image:desert
position 4 8 1 *
sprite @8,8 sprite:jigpiece (u32)0
door @4,8 map:304 @7,9 0x0000
switchable @3,8 (u16:fld)undemo
