9191919191919191919191919191919191919191
9191919191919191919191919191919191919191
9191919191919191919191919191919191919191
9191919191919191919191919191919191919191
a1a1a1a1a1a1a1a1a184919191919183a1a1a1a1
050505040100050305a08491919183a206000406
00001006060305000502a0849183a20600050103
0500010404050306060604a08492020506060601
0200020216dc0606050604049092050605060304
0488040505030403040401039092040004060200
0002000104040502db0003069092000203020400
0002000006050406000405019092000604050304

image image:desert
position 4 8 1 *
sprite @8,8 sprite:jigpiece (u32)0
door @4,8 map:304 @7,9 0x0000
