9191919191919191919191919191919191919191
9191919191919191919191919191919191919191
9191919191919191919191919191919191919191
9191919191919191919191919191919191919191
a1a1a1a1a1a1a1a1a184919191919183a1a1a1a1
020203010306040601a08491919183a206010200
02001204020502030506a0849183a20000010403
0404020146060300050400a08492030400030500
0005024616130402030602069092061113131310
0612020446010106020204019092031010111112
0406010304000403130104029092051312030600
0406030006010504060206019092021311040206

image image:desert
position 4 8 1 *
sprite @8,8 sprite:jigpiece (u32)0
door @4,8 map:304 @7,9 0x0000
switchable @3,8 (u16:fld)undemo
