2525353125253135253535252531313535312535
4141243125353125252535253135352525352535
0504404124353535253531312531312531313131
0200020440414141414124252535353123414141
0644000000030500050030312341414142050002
0002030403450405060040414200040404000601
0502064501040406060500000004050206000304
0305010206060005010003030405202122050005
0504020502000445000604060200302533212121
0102000206000502040504000501402425353125
0600020020212121212206010400023035313535
0000202134312535353321220501003031253125

image image:meadow
position 5 5 1 *
debugmsg "5,5"
sprite @8,6 sprite:jigpiece (u32)0
