9191919191919192020103050600030104020200
9191919191919192060405020006050206040002
9191919191919192040204030503030306040005
9191919191919192010403050504050204050004
91919191919183a2020106040503010201050200
9191919191919201030104040501060104010502
9191919191919205060501060605020103060300
919191919183a200010105060002040403060404
9191919191920606040300010002030401000002
9191919191920000030600010202040306010502
9191919183a20005040502050604010206000304
9191919192050205010002060504000606060502

image image:meadow
position -2 2 1 *
song song:toil_and_trouble
sprite @13,6 sprite:jigpiece (u32)0
rsprite (u16)0 sprite:goat (u32)0
