2531353531253532040503013035253125353125
3531312523414142060603004024252535313525
3525252342040605000506050040412425313525
4141414202010505020203000003044041414141
0305000605030104010106010106040501040206
0306010601040101050000050206000603000305
0606060106050503010606030004040406020601
0403020601040602060003040400040600020205
0601040406030006030503040201010601000100
0506060404000601020605040402050203000306
0002020102040302020100060506020403040304
0000050202010003010403040404000304060302

image image:meadow
position 0 1 1 *
