919191919191919191919183a1a1a18491919191
9191919191919191919191920302009091919191
919191919191919191919192024401a0a1a1a1a1
91919191919183a1a1a1a1a20603000601020106
a1a1a1a1a1a1a200060201000301010300000401
0304030404030403020106020403040100050300
0302040505010105010403040605010600020400
0104030104030100040206000603000405040600
1312101213121310100104020102020606030600
1112121113111310120604050403000201000206
0204060405021512130404040600000600010202
0000030604030310120206050303020300050000

image image:desert
position 5 8 1 *
sprite @14,5 sprite:jigpiece (u32)0
sprite @1,10 sprite:king (u16:activity)king (u16:activity_arg)0
sprite @4,10 sprite:linguist (u16:activity)linguist (u16:activity_arg)0
target @1,10 (u16:compass)castle
