919191919191919191919183a1a1a18491919191
9191919191919191919191920302009091919191
919191919191919191919192024401a0a1a1a1a1
91919191919183a1a1a1a1a20603000601020106
a1a1a1a1a1a1a200060201000301010300000401
0304030404030403020106020403040100050300
0302040505010105050403040605010600020400
0506000005030605100506000603000405040600
0300010306000005040204020102020606030600
0004060602010106060004050403000201000206
0404010102000305050104040600000600010202
0000030604040400020406050303020300050000

image image:desert
position 5 8 1 *
sprite @14,5 sprite:jigpiece (u32)0
