919191919191919191919183a1a1a18491919191
9191919191919191919191920302009091919191
919191919191919191919192053602a0a1a1a1a1
91919191919183a1a1a1a1a20104050104030303
a1a1a1a1a1a1a203020203040006050205010102
0206040203030206010505010504000106060106
0403010204040006040300010601050602000402
0600050304037a8b020505040203000001040004
0001030604037c87040604040004030436050204
0501010606050003010005050206030605030404
060101050000010201050001dd02010303060205
0300000102000100020205020201000403060104

image image:desert
position 5 8 1 *
sprite @14,5 sprite:jigpiece (u32)0
rspriteres rsprite:eastdesert
