a1a1a1a1a1a1a1a1a1a1a1a1a1a1a1a1a1a1a1a1
0502020306000401030405040302010501060004
0100000603030206010101010003050202000605
0106060202030001120003020306000104000104
0005000104050502010406020500060300000401
0004000503010503020106020403040100050300
0302040505010105050403040605010600020400
0506000005030605100506000603000405040600
0300010306000005040204020102020606030600
0004060602010106060004050403000201000206
0404010102000305050104040600000600010202
0000030604040400020406050303020300050000

image image:desert
position 5 8 1 *
sprite @14,5 sprite:jigpiece (u32)0
