9191919191919191919191919191919191919191
9191919191919191919191919191919191919191
a1a1a1a1a1a1a1a1a18491919191919191919191
040403040406010300a0a1849191919191919191
0600050306020200000502a0a1a1a1a1a1a18491
060300040505010602010604010404060403a0a1
0005040206030504060003040003020302050001
0305040600050302040604040101030303010604
0402050012000003060000020304060502060506
0100040406030403010204060403010204000006
0002000405000506000604020300010401060504
0506010406020005040106020000040004060000

image image:desert
position 6 8 1 *
sprite @6,4 sprite:jigpiece (u32)0
