a1a1a1a1a1a1a1a1a1a1a1a1a1a1a1a1a1a1a1a1
0605050002020201000403010001040403000401
0006050206040504050404050302060403020400
0603040605020404010206040406030303060103
0000060606040301010600030405030306060203
0205060005040003041006020504060605040002
0402020104050001050106000306020306000404
0005040306040503020106060104010502060404
0501010300010402000302010406020405040102
0304040403040001000506060005000506060501
0003010106020405020602040301020005010201
0503010403000506010504000503040402000404

image image:desert
position 7 8 1 *
sprite @5,5 sprite:jigpiece (u32)0
