9191919191919191919191919191919191919191
9191919191919191919191919191919191919191
9191919191919191919191919191919191919191
919191919191919191919191919183a1a1a1a1a1
9183a1a1a1a1a1a1a1a1a1a1a1a1a20505050605
a1a2060505040504061005010504060305040002
0203040104050001050106000306020306000404
0005040306040503020106060104010502060404
0501010300010402000302010406020405040102
0304040403040001000506060005000506060501
0003010106020405020602040301020005010201
0503010403000506010504000503040402000404

image image:desert
position 7 8 1 *
sprite @5,5 sprite:jigpiece (u32)0
rspriteres rsprite:eastdesert
