0000000000000000000000000000000000000000
0000000000000000000000000000000000000000
0000000000000000000000000000000000000000
0000000000444444000000004400000000000000
0000000000000044000000440044000000000000
0000000000000044000000004400000000000000
0000000000000044000000440044000000000000
0000000000000044004400004400000000000000
0000000000000000004400000000000000000000
0000000000000000000000000000000000000000
0000000000000000000000000000000000000000
0000000000000000000000000000000000000000

image image:meadow
position 7 8 1 *
