1110101310020301040006000506010002000502
1212111312020506040504030303030400060502
1310121111110204060005030501120000000400
1312121113110006020204040000040205000103
1110121012130206050502010503030103030005
1013131213050510060501020001050601060100
1011120605000405020404010200030501000500
1212120106000206041113121005060004010200
1201050405050204121306131010030506010403
1302010303131102000206060003010410020510
1101011212101310120203010504000102011010
1213111310131113131112131111131112111010

image image:desert
position 0 9 1 *
sprite @2,9 sprite:jigpiece (u32)0
