0001030506010506040406040202010200060600
0401020604040201000000020600010602000405
0000001103000003030006050503060001030300
0001000401000605000106260301020305000600
0603040104020100040104000600030006060103
0005060204020502030105020403010605000303
0202040304010002050002040305040106000406
0306010302051312101211121204060406000306
0503011011111213121313131213101212131211
1110121010121210131311131213121212101213
1010131313121213131112121111111211111211
1213111313121010121211121112111011121210

image image:desert
position 1 9 1 *
sprite @14,6 sprite:jigpiece (u32)0
bump @11,3 (u16:activity)tree (u16:fld)tree11 (u16)0
switchable @11,3 (u16:fld)tree11
