0300030000010303040000039092061011010505
0205000606010503050606019092041213121211
0000050105040604030403059092021310121013
0201020401060406000602049092000201040005
0003060504010603010300042838040006000005
0502060304030206060303059092020201111210
0403060100040203000606039092101212111211
1113110601060102010311119092111210131010
1110131111131211121213139092101313111013
1111131011111010111013119092131210121311
131310111111131010121113a0a2111012111211
1310121213111011131011131112111013131013

image image:desert
position 4 9 1 *
sprite @5,7 sprite:jigpiece (u32)0
sprite @11,5 sprite:bridget (u16:activity)bridget (u16:fld)bridge5start
switchable @13,4 (u16:fld)bridge5done
switchable @12,4 (u16:fld)bridge5done
