0603020404060012100301060306040501030201
1206041213111112130005050106060102010205
1200051212071312100603050501010000030005
0505050400170504010504010406030500040000
0103060201030305000106000205000005060100
1110121112121304050101000102010501040102
1013111311101313101200040406051211100405
1011121312131210111311131212131211121310
1311111210131010101110121310101111111012
1312121212131012101111121310131111111312
1212111011111011121210131111111010101112
1012101210111011111212131012111011121013

image image:desert
position 5 9 1 *
sprite @10,4 sprite:jigpiece (u32)0
busstop @5,2 (u16:busstop)castle
