3523414141414141243125313531353525352535
3532000303020606404141414124353531353535
3532000101010503020505040440414141414141
2342030405020300020403000106050000060401
3201050402040003010304040304010006040104
3203060501450301010202040505050003010002
3204014304040005060003505151515151515151
3202030203440402000504605371717171717171
3203034501020006000406606202020006000603
3322050605450601050504606200010405060306
3532024500000001010005606206060201020600
3132020200440005040003606205040405040203

image image:meadow
position 1 -3 1 *
song song:snowglobe
sprite @3,2 sprite:jigpiece (u32)0
