0505050300030305050602050502010505040405
05101112131415161718191a1b1c1d1e1f909105
8d202122232425262728292a2b2c2d2e2fa0a104
03303132333435363738393a3b3c3d3e3fb0b106
00404142434445464748494a4b4c4d4e4fc0c103
05505152535455565758595a5b5c5d5e5fd0d100
05606162636465666768696a6b6c6d6e6fe0e105
05707172737475767778797a7b7c7d7e7ff0f105
05808182838485868788898a8b8c8d8e8f929305
0505050505010101010101010101050505050505
0505050505050505050505050505050505050505
070807090a0708070a0809070807090a09080709

image image:castle_ext
position 5 9 1 *
busstop @13,7 (u16:busstop)castle
door @10,7 map:354 @9,10 0x0000
door @9,7 map:354 @9,10 0x0000
