0604050301030404040201000505020503000005
0006020306030600040006000201040504000202
0303030301030303000406010501060002000203
0404060504030302020002020513000403060600
0101000102000300010104020302040303020304
0305040104030202020003060202020001020003
0203030606010404060503040204030300010603
1213000606030204030300030400061010111010
1210101313060404001011111313131111111311
1210131011131211101012131112101012121013
1112111210131213111012121110111113101010
1113121111131012121012121211101011121213

image image:desert
position 6 9 1 *
sprite @6,8 sprite:jigpiece (u32)0
